"GEOID","tot200_b","univ_b","tot199_b","li_b","hi_b"
"34007609202",2898,4097,1199,0.292653160849402,0.707346839150598
"34007600700",568,1718,1150,0.669383003492433,0.330616996507567
"34007609205",4611,5339,728,0.13635512268215,0.86364487731785
"34007608206",3097,3702,605,0.163425175580767,0.836574824419233
"34007607801",3974,5765,1791,0.310667823070252,0.689332176929748
"34007607701",2729,4436,1707,0.384806131650135,0.615193868349865
"34007600200",1076,2464,1388,0.563311688311688,0.436688311688312
"34007600300",1424,3862,2438,0.631279129984464,0.368720870015536
"34007600500",139,826,687,0.831719128329298,0.168280871670702
"34007600800",1254,5536,4282,0.773482658959538,0.226517341040462
"34007600400",1358,3895,2537,0.651347881899872,0.348652118100128
"34007600900",1128,4341,3213,0.74015203870076,0.25984796129924
"34007608302",3475,4647,1172,0.25220572412309,0.74779427587691
"340213002",5620,5886,266,0.0451919809717975,0.954808019028203
"340212902",3836,4872,1036,0.21264367816092,0.78735632183908
"340212903",2363,2555,192,0.075146771037182,0.924853228962818
"340212601",3113,3904,791,0.202612704918033,0.797387295081967
"340212800",4612,6188,1576,0.254686489980608,0.745313510019392
"340212702",5363,6625,1262,0.190490566037736,0.809509433962264
"340212500",5340,6708,1368,0.203935599284436,0.796064400715564
"34007603501",5582,6192,610,0.0985142118863049,0.901485788113695
"34007603602",2591,2706,115,0.0424981522542498,0.95750184774575
"34007608403",5255,6139,884,0.143997393712331,0.856002606287669
"34007608901",4327,5522,1195,0.216407098877218,0.783592901122782
"34007608002",3255,3596,341,0.0948275862068965,0.905172413793103
"34007608903",3249,3592,343,0.0954899777282851,0.904510022271715
"34007603603",2094,2313,219,0.0946822308690013,0.905317769130999
"34007608700",5320,6095,775,0.127153404429861,0.872846595570139
"34007607401",2380,2873,493,0.171597633136095,0.828402366863905
"34007603302",5345,6041,696,0.115212713126966,0.884787286873034
"34007603200",4676,5676,1000,0.176180408738548,0.823819591261452
"34007603400",6494,7310,816,0.111627906976744,0.888372093023256
"34007602800",2089,2818,729,0.258694109297374,0.741305890702626
"34007607505",4031,4536,505,0.111331569664903,0.888668430335097
"34021100",1490,2927,1437,0.490946361462248,0.509053638537752
"340213703",3158,3462,304,0.0878105141536684,0.912189485846332
"340212602",3096,4040,944,0.233663366336634,0.766336633663366
"340213704",1839,2018,179,0.0887016848364718,0.911298315163528
"340213705",4781,5269,488,0.0926171949136459,0.907382805086354
"340213602",2830,3225,395,0.122480620155039,0.877519379844961
"340213601",2822,3323,501,0.150767378874511,0.849232621125489
"34007603303",1902,2359,457,0.193726155150487,0.806273844849512
"34007607702",3094,4459,1365,0.306122448979592,0.693877551020408
"34007606200",3594,3929,335,0.0852634258080937,0.914736574191906
"34007608202",3783,4255,472,0.110928319623972,0.889071680376028
"34007604400",2913,3367,454,0.134838134838135,0.865161865161865
"34007608504",1254,1782,528,0.296296296296296,0.703703703703704
"340213500",5477,6758,1281,0.189553122225511,0.81044687777449
"340213400",2036,2832,796,0.281073446327684,0.718926553672316
"340214404",6375,7394,1019,0.1378144441439,0.8621855558561
"340214405",4666,5257,591,0.112421533193837,0.887578466806163
"340214403",4203,5197,994,0.191264190879353,0.808735809120646
"340214406",4064,4997,933,0.18671202721633,0.81328797278367
"34007608209",3067,3563,496,0.139208532135841,0.860791467864159
"34007608208",6809,8602,1793,0.20843989769821,0.79156010230179
"34007607503",6073,6741,668,0.0990950897492954,0.900904910250705
"34007608205",3941,4220,279,0.0661137440758294,0.933886255924171
"34007606500",1969,2713,744,0.274235164025064,0.725764835974936
"34007606400",3066,3184,118,0.0370603015075377,0.962939698492462
"34007607900",1724,1967,243,0.12353838332486,0.87646161667514
"34007605400",2069,2531,462,0.182536546819439,0.817463453180561
"34007606300",1957,2173,216,0.0994017487344685,0.900598251265532
"34007607300",3302,4394,1092,0.248520710059172,0.751479289940828
"34007606600",2002,2318,316,0.136324417601381,0.86367558239862
"34007606901",2292,2851,559,0.196071553840758,0.803928446159242
"34007606700",4176,4729,553,0.116938041869317,0.883061958130683
"34007607100",3314,3853,539,0.139890994030625,0.860109005969375
"34007608502",4252,5084,832,0.163650668764752,0.836349331235248
"34007608501",16,16,0,0,1
"34007603503",4362,4702,340,0.0723096554657593,0.927690344534241
"34007605700",3250,3713,463,0.124697010503636,0.875302989496364
"34007605800",2606,2945,339,0.115110356536503,0.884889643463497
"34007605602",2266,2907,641,0.220502235982112,0.779497764017888
"34007607502",4068,4409,341,0.0773418008618734,0.922658199138127
"34007606800",3366,3892,526,0.135149023638232,0.864850976361768
"34007606000",1650,1957,307,0.15687276443536,0.84312723556464
"34007604200",2721,3477,756,0.217428817946506,0.782571182053494
"34007608001",2747,3561,814,0.228587475428251,0.771412524571749
"34007605601",2198,2550,352,0.138039215686275,0.861960784313725
"34007604700",1577,1909,332,0.173913043478261,0.826086956521739
"34007604001",598,716,118,0.164804469273743,0.835195530726257
"34007607000",3523,4376,853,0.194926873857404,0.805073126142596
"34007605900",2500,2639,139,0.0526714664645699,0.94732853353543
"34007607200",3285,4647,1362,0.293092317624274,0.706907682375726
"34007608404",5099,6044,945,0.156353408338848,0.843646591661152
"34007605100",2131,2691,560,0.208101077666295,0.791898922333705
"34007604900",2023,2998,975,0.325216811207472,0.674783188792528
"34007608301",8138,9685,1547,0.159731543624161,0.840268456375839
"34007608800",4574,5290,716,0.135349716446125,0.864650283553875
"34007603902",2514,2925,411,0.140512820512821,0.859487179487179
"34007605000",1536,2363,827,0.349978840457046,0.650021159542954
"34007605500",1631,1960,329,0.167857142857143,0.832142857142857
"34007605200",1831,2305,474,0.205639913232104,0.794360086767896
"34007609201",3871,4404,533,0.12102633969119,0.87897366030881
"34007604100",1789,2785,996,0.357630161579892,0.642369838420108
"34007605300",1760,2338,578,0.247219846022241,0.752780153977759
"34007609103",4033,4773,740,0.155038759689922,0.844961240310077
"34007609104",3780,4367,587,0.134417220059537,0.865582779940463
"34007602000",2844,5905,3061,0.518374259102455,0.481625740897545
"34007603504",2525,2687,162,0.0602902865649423,0.939709713435058
"34007601700",508,2948,2440,0.827679782903664,0.172320217096336
"34007601900",1035,3317,2282,0.687971058185107,0.312028941814893
"34007604300",3143,3937,794,0.201676403352807,0.798323596647193
"34007609204",3249,4295,1046,0.243538998835856,0.756461001164144
"34007603505",3092,3490,398,0.114040114613181,0.885959885386819
"340214307",5412,5987,575,0.0960414230833472,0.903958576916653
"34007604002",721,937,216,0.230522945570971,0.769477054429029
"34007603700",2914,3396,482,0.141931684334511,0.858068315665489
"34007603507",5977,6727,750,0.111491006392151,0.888508993607849
"34007603301",4156,5083,927,0.182372614597679,0.817627385402321
"340212904",5482,5880,398,0.067687074829932,0.932312925170068
"340213301",7049,7391,342,0.0462724935732648,0.953727506426735
"340214306",3992,4078,86,0.0210887690044139,0.978911230995586
"340214407",5928,6917,989,0.142981061153679,0.857018938846321
"340214304",7264,7595,331,0.0435813034891376,0.956418696510862
"340214301",3864,4241,377,0.0888941287432209,0.911105871256779
"340212400",1,1,0,0,1
"34007607501",6283,7770,1487,0.191377091377091,0.808622908622909
"34007608503",2782,3981,1199,0.301180607887465,0.698819392112535
"34007609203",5454,5966,512,0.0858196446530339,0.914180355346966
"34007610200",584,1064,480,0.451127819548872,0.548872180451128
"34007603506",6171,6572,401,0.0610164333536214,0.938983566646379
"34007604600",1794,2253,459,0.203728362183755,0.796271637816245
"340212701",2924,3516,592,0.168373151308305,0.831626848691695
"340212200",3506,5892,2386,0.404955872369314,0.595044127630686
"340212100",2698,5577,2879,0.516227362381209,0.483772637618791
"340212000",318,1394,1076,0.771879483500717,0.228120516499283
"340211900",885,1849,964,0.521362898864251,0.478637101135749
"340211800",2214,3659,1445,0.394916643891774,0.605083356108226
"34007608401",3778,4271,493,0.115429641770077,0.884570358229923
"34007607802",2109,2725,616,0.22605504587156,0.77394495412844
"34007610100",27,27,0,0,1
"34007604500",2255,3449,1194,0.34618730066686,0.65381269933314
"34007603901",4209,4878,669,0.137146371463715,0.862853628536285
"34007600600",216,316,100,0.316455696202532,0.683544303797468
"34007602701",26,26,0,0,1
"34007608904",1259,1362,103,0.0756240822320118,0.924375917767988
"34007603100",3083,3801,718,0.188897658510918,0.811102341489082
"340211700",2226,4480,2254,0.503125,0.496875
"340211600",471,1243,772,0.621078037007241,0.378921962992759
"340211500",1544,2906,1362,0.468685478320716,0.531314521679284
"340211402",1345,2575,1230,0.477669902912621,0.522330097087379
"340211401",1999,3712,1713,0.461476293103448,0.538523706896552
"340211200",2766,4009,1243,0.310052382140185,0.689947617859815
"34007602501",26,173,147,0.84971098265896,0.15028901734104
"34007602601",2238,2756,518,0.187953555878084,0.812046444121916
"34007602602",1931,2610,679,0.260153256704981,0.739846743295019
"34007609000",939,1421,482,0.339197748064743,0.660802251935257
"34007602503",1963,2591,628,0.242377460439985,0.757622539560015
"34007602703",1973,2329,356,0.152855302705024,0.847144697294976
"34007601500",2446,6200,3754,0.605483870967742,0.394516129032258
"34007603001",3081,3645,564,0.154732510288066,0.845267489711934
"340211100",3009,6594,3585,0.543676069153776,0.456323930846224
"340211300",2668,3493,825,0.23618665903235,0.76381334096765
"340211000",945,3129,2184,0.697986577181208,0.302013422818792
"34021900",1365,4281,2916,0.68114926419061,0.31885073580939
"34021800",1040,2346,1306,0.556692242114237,0.443307757885763
"34021700",1512,2488,976,0.392282958199357,0.607717041800643
"34007609102",149,172,23,0.133720930232558,0.866279069767442
"34007602502",826,1083,257,0.23730378578024,0.76269621421976
"34007607504",3746,3815,69,0.018086500655308,0.981913499344692
"34007602901",4572,4999,427,0.0854170834166833,0.914582916583317
"34007601400",2286,4743,2457,0.518026565464896,0.481973434535104
"34007601102",2009,4912,2903,0.591001628664495,0.408998371335505
"34007601600",946,2267,1321,0.582708425231584,0.417291574768416
"34007601000",2687,5671,2984,0.526185857873391,0.473814142126609
"34007601300",1493,4995,3502,0.701101101101101,0.298898898898899
"34007602702",3033,4056,1023,0.252218934911243,0.747781065088757
"34007601200",2810,6042,3232,0.534922211188348,0.465077788811652
"34007601101",1590,3716,2126,0.572120559741658,0.427879440258342
"34007603002",3591,4920,1329,0.270121951219512,0.729878048780488
"34021600",2965,3765,800,0.212483399734396,0.787516600265604
"34021500",2384,3533,1149,0.325219360317011,0.674780639682989
"34021400",2822,4583,1761,0.384246126991054,0.615753873008946
"34021300",2512,3629,1117,0.307798291540369,0.692201708459631
"34021200",1871,3437,1566,0.455629909805063,0.544370090194937
"340214204",4974,5757,783,0.136008337675873,0.863991662324127
"340214203",3280,3567,287,0.0804597701149425,0.919540229885057
"340214100",2455,2879,424,0.147273358805141,0.852726641194859
"340214000",3476,4378,902,0.206030150753769,0.793969849246231
"340213202",4535,5084,549,0.107985837922895,0.892014162077105
"340213903",2554,2696,142,0.0526706231454006,0.947329376854599
"340213201",4184,5090,906,0.177996070726916,0.822003929273085
"340213302",4973,5630,657,0.116696269982238,0.883303730017762
"340213100",3128,3745,617,0.16475300400534,0.83524699599466
"34007607600",2073,2377,304,0.127892301220025,0.872107698779975
"34007606100",2154,2302,148,0.0642919200695048,0.935708079930495
"34007606902",98,119,21,0.176470588235294,0.823529411764706
"34007608100",712,1033,321,0.310745401742498,0.689254598257502
"34007607402",1909,2291,382,0.166739415102575,0.833260584897425
"34007604800",796,1102,306,0.277676950998185,0.722323049001815
"34007603601",3056,3489,433,0.124104327887647,0.875895672112353
"34007603800",4702,5195,493,0.0948989412897016,0.905101058710298
"34007601800",509,1645,1136,0.690577507598784,0.309422492401216
"34007608402",2786,3251,465,0.143032912949862,0.856967087050138
"34007602902",2398,3147,749,0.238004448681284,0.761995551318716
"34007600100",35,97,62,0.639175257731959,0.360824742268041
"34007608600",3630,4986,1356,0.271961492178099,0.728038507821901
"340213706",3400,3742,342,0.0913949759486905,0.908605024051309
"340213800",6093,6299,206,0.0327036037466264,0.967296396253374
"340213902",1889,2035,146,0.0717444717444717,0.928255528255528
"340213901",8559,8920,361,0.0404708520179372,0.959529147982063
"340213004",5047,5697,650,0.11409513779182,0.88590486220818
"340213008",4034,4563,529,0.115932500547885,0.884067499452115
"340213007",3187,3414,227,0.0664909197422379,0.933509080257762
"340213006",5582,5937,355,0.0597945090112852,0.940205490988715
"340213009",4719,5025,306,0.0608955223880597,0.93910447761194
"340213003",5582,6048,466,0.0770502645502645,0.922949735449735
"34015502400",5198,6024,826,0.137118193891102,0.862881806108898
"34015502200",2684,3025,341,0.112727272727273,0.887272727272727
"340214201",5402,6298,896,0.142267386471896,0.857732613528104
"34015501404",828,1749,921,0.526586620926244,0.473413379073756
"34015501403",2436,3361,925,0.275215709610235,0.724784290389765
"34015502100",1990,2409,419,0.173931091739311,0.826068908260689
"34015501205",2110,2431,321,0.132044426162073,0.867955573837927
"34015501203",2967,3473,506,0.145695364238411,0.854304635761589
"34015501202",4950,5110,160,0.0313111545988258,0.968688845401174
"34015501603",4877,5905,1028,0.174089754445385,0.825910245554615
"34015501401",6842,8229,1387,0.168550249118969,0.831449750881031
"34015501301",3209,3667,458,0.124897736569403,0.875102263430597
"34015501208",3428,3644,216,0.0592755214050494,0.940724478594951
"34015501302",2246,2882,636,0.220680083275503,0.779319916724497
"34015501303",2158,2765,607,0.219529837251356,0.780470162748644
"34015501106",2756,3425,669,0.195328467153285,0.804671532846715
"34015501002",2506,3801,1295,0.340699815837937,0.659300184162063
"34015501001",1505,2191,686,0.313099041533546,0.686900958466454
"34015500800",2098,2317,219,0.0945187742770824,0.905481225722918
"34015501107",4241,4844,603,0.124483897605285,0.875516102394715
"34015500900",2582,2979,397,0.133266196710305,0.866733803289695
"34015500203",4375,4860,485,0.0997942386831276,0.900205761316872
"34015500703",1222,1366,144,0.105417276720351,0.894582723279649
"34015501104",2823,3199,376,0.117536730228196,0.882463269771804
"34015501204",3647,3987,340,0.0852771507399047,0.914722849260095
"34015501211",7902,8690,788,0.0906789413118527,0.909321058688147
"34015501003",3218,3845,627,0.163068920676203,0.836931079323797
"34015500702",4913,5623,710,0.126267117197226,0.873732882802774
"34015502300",1581,2048,467,0.22802734375,0.77197265625
"34015501402",1640,3254,1614,0.4960049170252,0.5039950829748
"34015502000",7911,8734,823,0.0942294481337303,0.90577055186627
"34015501607",6767,8067,1300,0.161150365687368,0.838849634312632
"34015501103",3868,4680,812,0.173504273504273,0.826495726495726
"34015501210",3909,4110,201,0.0489051094890511,0.951094890510949
"34015500204",3594,4105,511,0.124482338611449,0.875517661388551
"34015501105",1981,2383,402,0.168694922366765,0.831305077633235
"34015501206",3490,4076,586,0.143768400392542,0.856231599607458
"34015501500",5487,7085,1598,0.225546930134086,0.774453069865914
"34015500400",3912,6134,2222,0.36224323443104,0.63775676556896
"34015501701",3768,4393,625,0.142271796039153,0.857728203960847
"34015500205",2169,2672,503,0.188248502994012,0.811751497005988
"34015501201",5856,6318,462,0.0731244064577398,0.92687559354226
"34015501800",1321,1610,289,0.179503105590062,0.820496894409938
"34015501704",3472,4305,833,0.19349593495935,0.80650406504065
"34015500300",2509,3168,659,0.208017676767677,0.791982323232323
"34015500201",2281,2638,357,0.135329795299469,0.864670204700531
"34015501102",3151,3820,669,0.175130890052356,0.824869109947644
"34015501703",3463,4051,588,0.145149345840533,0.854850654159467
"34015500100",3454,4489,1035,0.230563599910893,0.769436400089107
"34015500202",4078,4852,774,0.159521846661171,0.840478153338829
"34015500500",4223,4865,642,0.131963001027749,0.868036998972251
"34015501101",3161,3838,677,0.176393955184992,0.823606044815008
"34015500600",4748,5253,505,0.0961355415952789,0.903864458404721
"34015501702",2140,2634,494,0.187547456340167,0.812452543659833
"34015501606",4550,5459,909,0.166514013555596,0.833485986444404
"34015501604",4422,5872,1450,0.246934604904632,0.753065395095368
"34015501605",2674,3425,751,0.219270072992701,0.780729927007299
"34015501900",2778,3482,704,0.202182653647329,0.797817346352671
"34015500701",6414,7191,777,0.10805173133083,0.89194826866917
"34007608204",90,460,370,0.804347826086957,0.195652173913043
"34007608207",4109,5079,970,0.190982476865525,0.809017523134475
"34015501209",4242,5031,789,0.156827668455575,0.843172331544425
"340214308",9474,10275,801,0.077956204379562,0.922043795620438
"340213001",5133,5677,544,0.0958252598203276,0.904174740179672
"34005702910",4335,4620,285,0.0616883116883117,0.938311688311688
"34005702907",2773,3066,293,0.0955642530984997,0.9044357469015
"34005702000",350,704,354,0.502840909090909,0.497159090909091
"34005701401",3139,3442,303,0.0880302149912841,0.911969785008716
"34005701402",1472,1648,176,0.106796116504854,0.893203883495146
"34005702909",5438,5973,535,0.0895697304537083,0.910430269546292
"34005703300",994,1145,151,0.131877729257642,0.868122270742358
"34005702811",2482,2753,271,0.0984380675626589,0.901561932437341
"34005702810",1233,1397,164,0.117394416607015,0.882605583392985
"34005702808",2929,3491,562,0.160985391005443,0.839014608994557
"34005702807",2288,2716,428,0.157584683357879,0.842415316642121
"34005702806",3167,3981,814,0.204471238382316,0.795528761617684
"34005702805",3263,4031,768,0.190523443314314,0.809476556685686
"34005702804",2418,2934,516,0.175869120654397,0.824130879345603
"34005702803",3637,3996,359,0.0898398398398398,0.91016016016016
"34005702802",2907,3612,705,0.195182724252492,0.804817275747508
"34005702801",2070,2265,195,0.0860927152317881,0.913907284768212
"34005702700",6426,7157,731,0.102137767220903,0.897862232779097
"34005703500",299,424,125,0.294811320754717,0.705188679245283
"34005702107",0,0,0,NA,NA
"34005702400",2987,3221,234,0.0726482458863707,0.927351754113629
"34005701801",2425,2572,147,0.057153965785381,0.942846034214619
"34005703203",3048,3842,794,0.206663196251952,0.793336803748048
"34005703202",2409,2682,273,0.10178970917226,0.898210290827741
"34005703201",3277,3741,464,0.124031007751938,0.875968992248062
"34005700200",2376,2639,263,0.0996589617279273,0.900341038272073
"34005700703",1751,2413,662,0.274347285536676,0.725652714463324
"34005700702",1920,2345,425,0.181236673773987,0.818763326226013
"34005700701",2434,3089,655,0.212042732275817,0.787957267724183
"34005702208",6135,7141,1006,0.14087662792326,0.85912337207674
"34005702204",1023,1724,701,0.40661252900232,0.59338747099768
"34005702206",1419,1791,372,0.207705192629816,0.792294807370184
"34005702110",0,0,0,NA,NA
"34005702205",6248,8109,1861,0.229498088543594,0.770501911456406
"34005702203",2914,3442,528,0.153399186519465,0.846600813480535
"34005702111",1762,2572,810,0.3149300155521,0.6850699844479
"34005702300",938,1209,271,0.224152191894127,0.775847808105873
"34005700104",1304,1773,469,0.264523406655386,0.735476593344614
"34005700103",2242,2517,275,0.109257052046087,0.890742947953913
"34005700102",2389,2760,371,0.134420289855072,0.865579710144928
"34005702101",1478,3062,1584,0.517308948399739,0.482691051600261
"34005701900",3586,4234,648,0.153046764289088,0.846953235710912
"34005704100",561,657,96,0.146118721461187,0.853881278538813
"34005702104",458,503,45,0.0894632206759443,0.910536779324056
"34005702905",3923,4162,239,0.057424315233061,0.942575684766939
"34005702906",1808,1933,125,0.0646663217796172,0.935333678220383
"34005702908",4174,4560,386,0.0846491228070175,0.915350877192982
"34005702911",7291,8013,722,0.0901035816797704,0.90989641832023
"34005702912",6710,7532,822,0.109134360063728,0.890865639936272
"34005702604",1503,2481,978,0.394195888754534,0.605804111245466
"34005702603",1445,2421,976,0.403139198678232,0.596860801321768
"34005702602",826,983,157,0.15971515768057,0.84028484231943
"34005702601",3896,4461,565,0.126653216767541,0.873346783232459
"34005700503",3262,3615,353,0.0976486860304288,0.902351313969571
"34005700502",1779,2021,242,0.119742701632855,0.880257298367145
"34005700501",4797,5387,590,0.109522925561537,0.890477074438463
"34005700505",4677,4762,85,0.0178496430071399,0.98215035699286
"34005700504",2511,2903,392,0.135032724767482,0.864967275232518
"34005703900",3906,4170,264,0.0633093525179856,0.936690647482014
"34005703804",6584,6827,243,0.035593965138421,0.964406034861579
"34005703803",4732,4932,200,0.040551500405515,0.959448499594485
"34005703802",3441,3831,390,0.101801096319499,0.898198903680501
"34005703801",6160,6422,262,0.0407972594207412,0.959202740579259
"34005703700",5946,6408,462,0.0720973782771536,0.927902621722846
"34005703600",6608,7085,477,0.0673253352152435,0.932674664784757
"34005700406",6158,7533,1375,0.182530200451347,0.817469799548653
"34005700405",1475,1732,257,0.14838337182448,0.85161662817552
"34005700403",3343,4098,755,0.184236212786725,0.815763787213275
"34005700402",2846,3379,533,0.157738976028411,0.842261023971589
"34005700401",1831,2016,185,0.091765873015873,0.908234126984127
"34005701802",35,39,4,0.102564102564103,0.897435897435897
"34005704012",5667,6182,515,0.0833063733419605,0.916693626658039
"34005702809",1384,1570,186,0.118471337579618,0.881528662420382
"34005702108",0,0,0,NA,NA
"34005703000",3676,4099,423,0.103195901439375,0.896804098560624
"34005701302",2251,2635,384,0.14573055028463,0.85426944971537
"34005701301",3624,4492,868,0.193232413178985,0.806767586821015
"34005701303",3139,3517,378,0.107477964174012,0.892522035825988
"34005704005",3498,3689,191,0.0517755489292491,0.948224451070751
"34005704004",3271,3790,519,0.136939313984169,0.863060686015831
"34005704011",2613,2912,299,0.102678571428571,0.897321428571429
"34005704009",3503,3859,356,0.0922518787250583,0.907748121274942
"34005704008",5262,5546,284,0.0512080778939776,0.948791922106022
"34005704007",2976,3406,430,0.126247798003523,0.873752201996477
"34005704006",2145,2266,121,0.0533980582524272,0.946601941747573
"34005701002",3563,4088,525,0.128424657534247,0.871575342465753
"34005701001",2975,3776,801,0.212129237288136,0.787870762711864
"34005702500",5402,6189,787,0.127161092260462,0.872838907739538
"34005700605",4602,4896,294,0.0600490196078431,0.939950980392157
"34005700303",2012,2356,344,0.146010186757216,0.853989813242784
"34005700602",4127,4503,376,0.0834998889629136,0.916500111037086
"34005700800",2615,3227,612,0.189649829563062,0.810350170436938
"34005700307",2210,2305,95,0.0412147505422994,0.958785249457701
"34005700306",2416,2583,167,0.0646535036778939,0.935346496322106
"34005700305",4499,4875,376,0.0771282051282051,0.922871794871795
"34005700304",2087,2324,237,0.10197934595525,0.89802065404475
"34005702112",43,43,0,0,1
"34005702106",0,0,0,NA,NA
"34005703101",7747,8862,1115,0.125818099751749,0.874181900248251
"34005701105",4220,4884,664,0.135954135954136,0.864045864045864
"34005701104",3489,4580,1091,0.2382096069869,0.7617903930131
"34005701103",5049,5787,738,0.127527216174184,0.872472783825817
"34005701102",3750,4174,424,0.101581217057978,0.898418782942022
"34005701205",1769,2290,521,0.227510917030568,0.772489082969432
"34005701204",1536,2590,1054,0.406949806949807,0.593050193050193
"34005701203",1488,1869,381,0.203852327447833,0.796147672552167
"34005701201",2466,2948,482,0.163500678426052,0.836499321573948
"34005701600",465,528,63,0.119318181818182,0.880681818181818
"34005701502",2867,3272,405,0.123777506112469,0.876222493887531
"34005701501",4583,5080,497,0.0978346456692913,0.902165354330709
"34005701700",3171,3938,767,0.194768918232605,0.805231081767395
"34005700900",1864,2623,759,0.289363324437667,0.710636675562333
"34005703400",1266,1546,280,0.18111254851229,0.81888745148771
"34005703102",1179,1274,95,0.0745682888540031,0.925431711145997
"34005700603",4798,6118,1320,0.215756783262504,0.784243216737496
"34005702207",2846,3878,1032,0.266116554925219,0.733883445074781
"34005702109",1603,2065,462,0.223728813559322,0.776271186440678
"34005704014",4532,4824,292,0.060530679933665,0.939469320066335
"34005704013",5404,5768,364,0.0631067961165049,0.936893203883495
"42045401302",2768,3159,391,0.123773345995568,0.876226654004432
"42045407804",3949,4357,408,0.0936424145053936,0.906357585494606
"42045409500",4235,4637,402,0.0866939831787794,0.913306016821221
"42045410000",3373,3573,200,0.0559753708368318,0.944024629163168
"42045408500",3497,4004,507,0.126623376623377,0.873376623376623
"42045404400",1134,1474,340,0.230664857530529,0.769335142469471
"42045401800",3129,3732,603,0.161575562700965,0.838424437299035
"42045401900",4159,4732,573,0.121090448013525,0.878909551986475
"42045400301",3892,6136,2244,0.365710560625815,0.634289439374185
"42045401402",3315,4020,705,0.175373134328358,0.824626865671642
"42045407201",3449,3906,457,0.11699948796723,0.88300051203277
"42045406903",4815,5424,609,0.112278761061947,0.887721238938053
"42045408102",3122,3532,410,0.116081540203851,0.883918459796149
"42045400402",2470,3970,1500,0.377833753148615,0.622166246851385
"42045409400",2361,2649,288,0.10872027180068,0.891279728199321
"42045407401",3447,3738,291,0.0778491171749599,0.92215088282504
"42045407102",2969,3184,215,0.0675251256281407,0.932474874371859
"42045409000",3227,3651,424,0.116132566420159,0.883867433579841
"42045410200",2926,3155,229,0.0725832012678288,0.927416798732171
"42029303100",4085,4221,136,0.0322198531153755,0.967780146884625
"42029303000",2544,2731,187,0.0684730867813988,0.931526913218601
"42045401103",3129,3546,417,0.117597292724196,0.882402707275804
"42045406500",1180,1827,647,0.354132457580733,0.645867542419267
"42045402900",1716,3358,1642,0.488981536628946,0.511018463371054
"42045407501",1912,2242,330,0.147190008920607,0.852809991079393
"42045404500",2690,4920,2230,0.453252032520325,0.546747967479675
"42045408101",4168,4617,449,0.0972492960797054,0.902750703920295
"42045409601",3957,4641,684,0.147382029734971,0.852617970265029
"42045408400",1803,1893,90,0.0475435816164818,0.952456418383518
"42045407700",2241,2708,467,0.17245199409158,0.827548005908419
"42045409904",3026,3253,227,0.0697817399323701,0.93021826006763
"42045407404",2572,2811,239,0.0850231234436144,0.914976876556386
"42045406401",1837,2872,1035,0.360376044568245,0.639623955431755
"42045406201",2381,2918,537,0.184030157642221,0.815969842357779
"42045404103",2756,3461,705,0.203698353077145,0.796301646922855
"42045407502",2167,2898,731,0.25224292615597,0.74775707384403
"42045407101",3334,3466,132,0.0380842469705713,0.961915753029429
"42045407600",4559,4905,346,0.0705402650356779,0.929459734964322
"42045408002",3853,4366,513,0.11749885478699,0.88250114521301
"42045408103",3496,4459,963,0.215967705763624,0.784032294236376
"42045406700",2449,3566,1117,0.313236118900729,0.686763881099271
"42045408600",3257,3548,291,0.0820180383314543,0.917981961668546
"42045403200",3702,4300,598,0.13906976744186,0.860930232558139
"42045402400",1569,3502,1933,0.55197030268418,0.44802969731582
"42045401501",3010,3536,526,0.148755656108597,0.851244343891403
"42045402000",1903,2529,626,0.247528667457493,0.752471332542507
"42045401200",3347,3780,433,0.114550264550265,0.885449735449735
"42045404101",5064,6410,1346,0.209984399375975,0.790015600624025
"42045407202",2678,3032,354,0.116754617414248,0.883245382585752
"42045405600",402,655,253,0.386259541984733,0.613740458015267
"42045405300",1686,3513,1827,0.520068317677199,0.479931682322801
"42045407801",3619,4026,407,0.101092896174863,0.898907103825137
"42045405000",1199,2456,1257,0.511807817589576,0.488192182410424
"42045410100",3897,4860,963,0.198148148148148,0.801851851851852
"42045404800",1180,2700,1520,0.562962962962963,0.437037037037037
"42045405100",1021,2189,1168,0.533576975788031,0.466423024211969
"42045404900",562,1758,1196,0.680318543799773,0.319681456200227
"42045406202",4342,5053,711,0.140708490005937,0.859291509994063
"42045403001",2741,3264,523,0.160232843137255,0.839767156862745
"42045401502",3440,4379,939,0.214432518839918,0.785567481160082
"42045400500",3143,4134,991,0.239719400096759,0.760280599903241
"42045404003",1483,1746,263,0.150630011454754,0.849369988545246
"42045407902",2429,2735,306,0.111882998171846,0.888117001828154
"42045407903",3162,3609,447,0.123857024106401,0.876142975893599
"42045406904",3463,4042,579,0.143245917862444,0.856754082137556
"42045407805",1467,1654,187,0.113059250302297,0.886940749697703
"42045400801",1419,1798,379,0.210789766407119,0.789210233592881
"42045400700",3928,5090,1162,0.228290766208251,0.771709233791748
"42045403901",2735,3419,684,0.200058496636443,0.799941503363557
"42045405700",812,1998,1186,0.593593593593594,0.406406406406406
"42045409300",2332,2478,146,0.0589184826472962,0.941081517352704
"42045405200",998,2707,1709,0.631326191355744,0.368673808644256
"42045407803",4924,5279,355,0.0672475847698428,0.932752415230157
"42045400802",2997,3504,507,0.144691780821918,0.855308219178082
"42045405400",1204,2282,1078,0.47239263803681,0.52760736196319
"42045400900",1491,1674,183,0.109318996415771,0.890681003584229
"42045401101",2382,2902,520,0.179186767746382,0.820813232253618
"42045401000",1705,1938,233,0.120227038183695,0.879772961816305
"42045404300",1584,2442,858,0.351351351351351,0.648648648648649
"42045403401",2447,3107,660,0.212423559703894,0.787576440296106
"42045404700",1095,2551,1456,0.570756566052528,0.429243433947472
"42045409100",3887,4221,334,0.0791281686804075,0.920871831319592
"42045403402",3098,3864,766,0.19824016563147,0.80175983436853
"42045407901",3897,4149,252,0.0607375271149675,0.939262472885033
"42045401401",1879,2144,265,0.123600746268657,0.876399253731343
"42045400401",2750,4765,2015,0.422875131164743,0.577124868835257
"42045402600",2004,2992,988,0.330213903743315,0.669786096256685
"42045400100",580,942,362,0.384288747346072,0.615711252653928
"42045402700",1502,2451,949,0.38718890248878,0.61281109751122
"42045400200",2085,3853,1768,0.458863223462237,0.541136776537763
"42045409701",5363,5705,342,0.0599474145486415,0.940052585451359
"42045400302",2359,3663,1304,0.355992355992356,0.644007644007644
"42045409802",3454,3684,230,0.0624321389793702,0.93756786102063
"42045406802",3602,4606,1004,0.217976552323057,0.782023447676943
"42045409602",2443,3332,889,0.266806722689076,0.733193277310924
"42045410301",4573,4788,215,0.0449039264828738,0.955096073517126
"42045401700",1930,2570,640,0.249027237354086,0.750972762645914
"42045404200",710,860,150,0.174418604651163,0.825581395348837
"42045404600",1555,2408,853,0.354235880398671,0.645764119601329
"42045406300",1809,2963,1154,0.389470131623355,0.610529868376645
"42045410302",4691,5051,360,0.071273015244506,0.928726984755494
"42045407000",2281,2525,244,0.0966336633663366,0.903366336633663
"42045406600",1336,2302,966,0.419635099913119,0.580364900086881
"42045409903",3731,4055,324,0.079901356350185,0.920098643649815
"42045405800",857,2410,1553,0.644398340248963,0.355601659751037
"42045404002",6218,7195,977,0.135788742182071,0.864211257817929
"42045404102",3960,5361,1401,0.261331841074426,0.738668158925574
"42045404004",5651,6563,912,0.138960841078775,0.861039158921225
"42045408001",5697,6092,395,0.0648391332895601,0.93516086671044
"42045406902",5594,6271,677,0.107957263594323,0.892042736405677
"42045409702",374,482,108,0.224066390041494,0.775933609958506
"42045407806",1534,1770,236,0.133333333333333,0.866666666666667
"42045409902",3718,4203,485,0.115393766357364,0.884606233642636
"421015400",937,1226,289,0.235725938009788,0.764274061990212
"421015500",4181,5777,1596,0.276267959148347,0.723732040851653
"42045403902",3364,3711,347,0.0935057935866343,0.906494206413366
"42045402300",2712,3434,722,0.210250436808387,0.789749563191613
"42045403002",2388,2978,590,0.198119543317663,0.801880456682337
"42045402500",2081,3398,1317,0.387580929958799,0.612419070041201
"42045403103",1910,2687,777,0.289170078154075,0.710829921845925
"42045403101",2852,3545,693,0.195486600846262,0.804513399153738
"42045402800",4041,5409,1368,0.252911813643927,0.747088186356073
"42045410400",5988,6335,347,0.0547750591949487,0.945224940805051
"42045406803",6933,7770,837,0.107722007722008,0.892277992277992
"42045402200",1621,2016,395,0.19593253968254,0.80406746031746
"42045406801",3644,4413,769,0.174257874461817,0.825742125538183
"42045403502",2172,2895,723,0.249740932642487,0.750259067357513
"42045403701",1362,1785,423,0.236974789915966,0.763025210084034
"42045403702",1987,2550,563,0.22078431372549,0.77921568627451
"42045403104",1491,2404,913,0.379783693843594,0.620216306156406
"42045403300",5025,6752,1727,0.255776066350711,0.744223933649289
"42045406100",1862,2259,397,0.175741478530323,0.824258521469677
"42045403601",3328,4023,695,0.172756649266716,0.827243350733284
"42045406402",777,1646,869,0.527946537059538,0.472053462940462
"42045407300",900,944,44,0.0466101694915254,0.953389830508475
"42045403800",5225,6424,1199,0.186643835616438,0.813356164383562
"42045403602",1530,1950,420,0.215384615384615,0.784615384615385
"42045402100",5221,5939,718,0.120895773699276,0.879104226300724
"42045403501",3384,4546,1162,0.255609326880774,0.744390673119226
"42045408900",2923,3054,131,0.0428945645055665,0.957105435494433
"42045407403",5815,6639,824,0.124115077571923,0.875884922428076
"42045408800",4472,5008,536,0.10702875399361,0.89297124600639
"42045408300",3129,3809,680,0.17852454712523,0.82147545287477
"42045409200",3548,4136,588,0.142166344294004,0.857833655705996
"42045409803",6024,7067,1043,0.14758737795387,0.85241262204613
"42045407802",5844,6446,602,0.0933912503878374,0.906608749612163
"42045408700",4464,5017,553,0.110225234203707,0.889774765796293
"42045401104",3749,4346,597,0.137367694431661,0.862632305568339
"42045400600",3978,5030,1052,0.209145129224652,0.790854870775348
"42045401600",1420,1795,375,0.20891364902507,0.79108635097493
"42045401301",1710,2372,662,0.279089376053963,0.720910623946037
"42017101610",4371,4881,510,0.104486785494776,0.895513214505224
"42017101504",2514,2977,463,0.155525697010413,0.844474302989587
"42017103001",3778,4680,902,0.192735042735043,0.807264957264957
"42017103200",925,1161,236,0.203273040482343,0.796726959517657
"42017103300",1855,2184,329,0.150641025641026,0.849358974358974
"42017105809",4017,4463,446,0.0999327806408246,0.900067219359175
"42017100403",1322,2143,821,0.383107792813812,0.616892207186188
"42017100206",3895,4447,552,0.124128626040027,0.875871373959973
"42017101404",2200,2362,162,0.0685859441151566,0.931414055884843
"42017105812",1435,1737,302,0.173862982153138,0.826137017846862
"42017100212",3947,4385,438,0.0998859749144812,0.900114025085519
"42017105506",3833,4105,272,0.0662606577344702,0.93373934226553
"42017102400",7731,8815,1084,0.122972206466251,0.877027793533749
"42017102300",4402,5153,751,0.145740345429847,0.854259654570153
"42091207600",3224,3680,456,0.123913043478261,0.876086956521739
"42017100304",1510,2439,929,0.380893808938089,0.619106191061911
"42017103800",1131,1399,268,0.1915654038599,0.8084345961401
"42017102900",904,1053,149,0.141500474833808,0.858499525166192
"42017105003",4655,4935,280,0.0567375886524823,0.943262411347518
"42017102200",893,997,104,0.104312938816449,0.895687061183551
"42017101000",755,893,138,0.154535274356103,0.845464725643897
"42017101700",434,469,35,0.0746268656716418,0.925373134328358
"42017101300",1210,1317,107,0.0812452543659833,0.918754745634017
"42017105011",3518,3813,295,0.0773669027012851,0.922633097298715
"42017100811",3494,4422,928,0.209859791949344,0.790140208050656
"42017105806",73,107,34,0.317757009345794,0.682242990654206
"42017104100",1713,2078,365,0.175649663137632,0.824350336862368
"42017105400",6577,7168,591,0.0824497767857143,0.917550223214286
"4210136500",7722,9273,1551,0.167259786476868,0.832740213523132
"42017103500",1143,1322,179,0.135400907715582,0.864599092284418
"42017101405",5629,6469,840,0.129850054104189,0.870149945895811
"42017100102",2297,2760,463,0.167753623188406,0.832246376811594
"42017100207",2421,3842,1421,0.36985944820406,0.63014055179594
"42017103400",4534,4944,410,0.0829288025889968,0.917071197411003
"42017100208",4280,6432,2152,0.334577114427861,0.665422885572139
"42017100210",6416,7418,1002,0.13507684011863,0.86492315988137
"42017100402",5698,6519,821,0.125939561282405,0.874060438717595
"42017105704",4999,6670,1671,0.250524737631184,0.749475262368816
"42017101607",2553,2996,443,0.147863818424566,0.852136181575434
"42017101605",2500,4188,1688,0.40305635148042,0.59694364851958
"42017104000",4325,4777,452,0.0946200544274649,0.905379945572535
"42017100500",1954,2610,656,0.251340996168582,0.748659003831418
"42017100303",3334,4990,1656,0.33186372745491,0.66813627254509
"42017100809",4821,4916,95,0.0193246541903987,0.980675345809601
"42017100302",3854,5112,1258,0.246087636932707,0.753912363067293
"42017100201",3463,4309,846,0.196333255975864,0.803666744024136
"42017104800",2089,2360,271,0.114830508474576,0.885169491525424
"42017100104",3021,4426,1405,0.317442385901491,0.682557614098509
"42017102600",1707,2062,355,0.172162948593598,0.827837051406402
"42017105204",10247,10726,479,0.0446578407607682,0.955342159239232
"42017100211",5579,6329,750,0.118502133038395,0.881497866961605
"42017105900",1514,2023,509,0.251606524962926,0.748393475037074
"42017102500",3827,4572,745,0.162948381452318,0.837051618547682
"42017100307",4302,4993,691,0.138393751251752,0.861606248748248
"42017100401",5360,6548,1188,0.18142944410507,0.81857055589493
"42017100306",2475,3614,1139,0.315163254012175,0.684836745987825
"42017105009",3246,3553,307,0.0864058542077118,0.913594145792288
"42017104603",4608,5047,439,0.0869823657618387,0.913017634238161
"42017103700",2964,3501,537,0.153384747215081,0.846615252784919
"42017100803",4423,4865,442,0.0908530318602261,0.909146968139774
"42017105702",2463,3296,833,0.252730582524272,0.747269417475728
"42017100404",5294,6305,1011,0.160348929421094,0.839651070578906
"42017100700",2240,3337,1097,0.328738387773449,0.671261612226551
"42017103900",3668,4173,505,0.121016055595495,0.878983944404505
"42017100407",1111,1339,228,0.170276325616131,0.829723674383869
"42017104502",3830,4180,350,0.0837320574162679,0.916267942583732
"42017102003",3633,3782,149,0.0393971443680592,0.960602855631941
"42017100600",2717,3945,1228,0.31128010139417,0.68871989860583
"42017105811",4862,6113,1251,0.204645836741371,0.795354163258629
"42017105100",2572,2834,262,0.0924488355681016,0.907551164431898
"42017101804",7759,8501,742,0.087283848958946,0.912716151041054
"42017105501",7604,8153,549,0.0673371764994481,0.932662823500552
"42017105505",3738,3932,194,0.0493387589013225,0.950661241098678
"42017105807",2593,3496,903,0.258295194508009,0.741704805491991
"42017104702",2170,2483,313,0.126057188884414,0.873942811115586
"42017104901",6023,6291,268,0.0426005404546177,0.957399459545382
"42017101401",3509,3976,467,0.117454728370221,0.882545271629779
"42017100103",1916,2527,611,0.241788682231896,0.758211317768104
"42017102002",2671,2834,163,0.0575158786167961,0.942484121383204
"42017105507",7090,7338,248,0.0337966748432815,0.966203325156718
"42017105805",4521,5791,1270,0.219305819374892,0.780694180625108
"42017104701",2578,3089,511,0.165425704111363,0.834574295888637
"42017101803",4509,4874,365,0.074887156339762,0.925112843660238
"42017104703",2076,2290,214,0.0934497816593887,0.906550218340611
"42017100209",6835,7950,1115,0.140251572327044,0.859748427672956
"42017100408",5689,7028,1339,0.190523619806488,0.809476380193512
"42017105801",5976,6801,825,0.121305690339656,0.878694309660344
"42017105808",3147,3632,485,0.133535242290749,0.866464757709251
"42017105008",2632,2954,322,0.109004739336493,0.890995260663507
"42091209201",1222,1556,334,0.214652956298201,0.7853470437018
"42017101403",5683,6308,625,0.0990805326569436,0.900919467343056
"42017100406",3775,4091,316,0.0772427279393791,0.922757272060621
"42017103002",4256,5215,959,0.183892617449664,0.816107382550336
"42017104604",5475,6152,677,0.110045513654096,0.889954486345904
"42017104601",4377,4752,375,0.0789141414141414,0.921085858585859
"42017102103",3760,3967,207,0.0521804890345349,0.947819510965465
"42017101200",813,927,114,0.122977346278317,0.877022653721683
"42017102802",5028,5591,563,0.100697549633339,0.899302450366661
"42017100900",6939,7799,860,0.110270547506091,0.889729452493909
"42017100805",5617,6281,664,0.105715650374144,0.894284349625856
"42017104300",7043,7674,631,0.082225697159239,0.917774302840761
"42017101611",5849,6558,709,0.108112229338213,0.891887770661787
"42017105810",2307,2629,322,0.122480030429821,0.877519969570179
"42017104200",10450,11380,930,0.0817223198594025,0.918277680140598
"42017103600",725,851,126,0.148061104582844,0.851938895417156
"42017102700",3446,4095,649,0.158485958485958,0.841514041514042
"42017101603",2615,3066,451,0.147097195042401,0.8529028049576
"42017100807",2415,2602,187,0.0718677940046118,0.928132205995388
"42017104501",10839,12103,1264,0.104436916466992,0.895563083533008
"42017105600",2193,2491,298,0.119630670413489,0.880369329586511
"42017105503",8430,9012,582,0.0645805592543276,0.935419440745672
"42017100804",3381,3641,260,0.0714089535841802,0.92859104641582
"42017102004",3684,4082,398,0.0975012248897599,0.90249877511024
"42017105007",7991,8377,386,0.0460785484063507,0.953921451593649
"42017104400",1890,2248,358,0.159252669039146,0.840747330960854
"42017101608",3887,4651,764,0.164265749301226,0.835734250698774
"42017105004",5075,5552,477,0.0859149855907781,0.914085014409222
"42017103103",3322,4181,859,0.205453240851471,0.794546759148529
"42017105010",3697,3933,236,0.0600050851767099,0.93999491482329
"42017101609",4327,4753,426,0.0896276036187671,0.910372396381233
"42017104902",5319,5675,356,0.0627312775330396,0.93726872246696
"42017101900",3520,3900,380,0.0974358974358974,0.902564102564103
"42017105300",1994,2178,184,0.0844811753902663,0.915518824609734
"42017105202",4837,5291,454,0.0858060858060858,0.914193914193914
"42017101100",1596,2177,581,0.266881028938907,0.733118971061093
"42017105006",5527,5921,394,0.0665428137138997,0.9334571862861
"42017100810",2762,3463,701,0.202425642506497,0.797574357493503
"42017101802",3789,4128,339,0.0821220930232558,0.917877906976744
"42017102104",3774,4876,1102,0.226004922067268,0.773995077932732
"42017100808",4816,5087,271,0.0532730489482996,0.9467269510517
"42017102801",2765,3085,320,0.103727714748784,0.896272285251216
"42017105203",2036,2097,61,0.0290891750119218,0.970910824988078
"42017103101",1853,2422,569,0.234929810074319,0.765070189925681
"42017101505",3049,3406,357,0.104815032295948,0.895184967704052
"42017101503",3535,3959,424,0.107097751957565,0.892902248042435
"42017102102",2661,3117,456,0.146294513955727,0.853705486044273
"42017103102",1625,2134,509,0.238519212746017,0.761480787253983
"42017101506",4833,5378,545,0.101338787653403,0.898661212346597
"42017100105",2646,3306,660,0.199637023593466,0.800362976406534
"42029304201",5796,6400,604,0.094375,0.905625
"42029303402",1341,1801,460,0.25541365907829,0.74458634092171
"42029303700",1006,1150,144,0.125217391304348,0.874782608695652
"42029304800",843,957,114,0.119122257053292,0.880877742946709
"42029306700",3548,3762,214,0.0568846358320043,0.943115364167996
"42029300108",5323,6058,735,0.121327170683394,0.878672829316606
"42029302703",3564,3694,130,0.0351922035733622,0.964807796426638
"42029302704",4312,4510,198,0.0439024390243902,0.95609756097561
"42029306300",2134,2628,494,0.187975646879756,0.812024353120244
"42029302204",5211,5835,624,0.10694087403599,0.89305912596401
"42029306400",654,1095,441,0.402739726027397,0.597260273972603
"42029307600",833,1210,377,0.311570247933884,0.688429752066116
"42029301201",0,0,0,NA,NA
"42029304202",4156,4912,756,0.153908794788274,0.846091205211726
"42029300500",5870,6716,846,0.125967837998809,0.874032162001191
"42029305300",4069,4981,912,0.183095763902831,0.816904236097169
"42029302000",3410,3670,260,0.0708446866485014,0.929155313351499
"42029310200",107,122,15,0.122950819672131,0.877049180327869
"42029305600",1391,2713,1322,0.487283450055289,0.512716549944711
"42029305500",1554,3452,1898,0.549826187717265,0.450173812282735
"42029305700",1744,2313,569,0.246000864677907,0.753999135322093
"42029304101",3246,3951,705,0.178435839028094,0.821564160971906
"42029304102",2894,3401,507,0.149073801822993,0.850926198177007
"42029303900",8308,8758,450,0.0513815939712263,0.948618406028774
"42029306000",4437,5048,611,0.121038034865293,0.878961965134707
"42029304300",5259,5822,563,0.0967021642047406,0.903297835795259
"42029302805",5850,6524,674,0.103310852237891,0.896689147762109
"42029303500",5973,6291,318,0.050548402479733,0.949451597520267
"42029302803",2042,2239,197,0.0879857079053149,0.912014292094685
"42029304000",2544,2849,305,0.107055107055107,0.892944892944893
"42029302804",3440,3711,271,0.0730261385071409,0.926973861492859
"42029301300",3749,4343,594,0.136771816716555,0.863228183283445
"42029308100",4446,5481,1035,0.188834154351396,0.811165845648604
"42029300202",5033,5196,163,0.0313702848344881,0.968629715165512
"42029301700",1406,1644,238,0.144768856447689,0.855231143552311
"42029302101",4416,5096,680,0.133437990580848,0.866562009419152
"42029301202",4497,5187,690,0.133024869866975,0.866975130133025
"42029302102",3058,3400,342,0.100588235294118,0.899411764705882
"42029306800",1315,1519,204,0.13429888084266,0.86570111915734
"42029301000",6064,6551,487,0.0743397954510762,0.925660204548924
"42029305100",5767,7046,1279,0.181521430598921,0.818478569401079
"42029307200",947,1122,175,0.155971479500891,0.844028520499109
"42029300400",2661,3049,388,0.127254837651689,0.872745162348311
"42029304900",4759,5956,1197,0.200973807924782,0.799026192075218
"42029303300",5689,6409,720,0.112342019035731,0.887657980964269
"42029302802",4163,4344,181,0.0416666666666667,0.958333333333333
"42029310500",461,483,22,0.0455486542443064,0.954451345755694
"42029305000",1055,1276,221,0.173197492163009,0.826802507836991
"42029306600",2644,2793,149,0.0533476548514143,0.946652345148586
"42029307100",1253,1613,360,0.223186608803472,0.776813391196528
"42029306200",4673,5256,583,0.110920852359209,0.889079147640791
"42029307900",2151,3033,882,0.29080118694362,0.70919881305638
"42029303401",2519,3379,860,0.254513169576798,0.745486830423202
"42029307000",2330,2796,466,0.166666666666667,0.833333333333333
"42029306500",7634,9074,1440,0.158695173021821,0.841304826978179
"42029305900",318,572,254,0.444055944055944,0.555944055944056
"42029306900",4274,4538,264,0.0581754076685765,0.941824592331424
"42029308000",2583,4155,1572,0.378339350180505,0.621660649819495
"42029301402",4234,4657,423,0.0908310070861069,0.909168992913893
"42029305200",6244,7012,768,0.109526525955505,0.890473474044495
"42029301401",2134,2705,571,0.211090573012939,0.788909426987061
"42029307400",2655,3373,718,0.212866884079455,0.787133115920545
"42029300800",3533,4192,659,0.157204198473282,0.842795801526718
"42029303200",2775,2850,75,0.0263157894736842,0.973684210526316
"42029300600",2940,3483,543,0.155900086132644,0.844099913867356
"42029301500",1652,1856,204,0.109913793103448,0.890086206896552
"42029300700",3369,4565,1196,0.261993428258488,0.738006571741512
"42029300900",2166,2402,236,0.0982514571190675,0.901748542880933
"42029305800",604,993,389,0.391742195367573,0.608257804632427
"42029300201",4426,4900,474,0.096734693877551,0.903265306122449
"42029307300",2110,2571,461,0.179307662388176,0.820692337611824
"42029303600",2285,2384,99,0.0415268456375839,0.958473154362416
"42029310900",25,76,51,0.671052631578947,0.328947368421053
"42029302203",4202,4461,259,0.0580587312261825,0.941941268773818
"42029300107",4086,4299,213,0.049546406140963,0.950453593859037
"42029300301",3025,3367,342,0.101574101574102,0.898425898425898
"42029301100",2534,3245,711,0.219106317411402,0.780893682588598
"42029300104",4589,5018,429,0.0854922279792746,0.914507772020725
"42029300103",2047,2494,447,0.179230152365678,0.820769847634322
"42029300109",3315,3564,249,0.0698653198653199,0.93013468013468
"42029300106",4318,4618,300,0.064963187527068,0.935036812472932
"42029307800",1797,2094,297,0.141833810888252,0.858166189111748
"42029304500",6292,6839,547,0.0799824535750841,0.920017546424916
"42029304403",3594,3893,299,0.0768045209350116,0.923195479064988
"42029301600",2183,2550,367,0.143921568627451,0.856078431372549
"42029303802",6384,6840,456,0.0666666666666667,0.933333333333333
"42029303801",2993,3373,380,0.112659353691076,0.887340646308924
"42029304402",7437,7786,349,0.0448240431543797,0.95517595684562
"42029304404",4569,4869,300,0.0616142945163278,0.938385705483672
"42029302300",1729,2320,591,0.254741379310345,0.745258620689655
"42029302400",2800,3933,1133,0.288075260615306,0.711924739384694
"42029302500",2675,3876,1201,0.309855521155831,0.690144478844169
"42029302600",1697,4489,2792,0.621964802851415,0.378035197148585
"42029310400",0,0,0,NA,NA
"42029302701",6721,7383,662,0.0896654476500068,0.910334552349993
"42029307700",1835,2477,642,0.259184497375858,0.740815502624142
"42029302702",3985,4683,698,0.14904975443092,0.85095024556908
"42029306100",730,856,126,0.147196261682243,0.852803738317757
"42029304700",1671,2024,353,0.174407114624506,0.825592885375494
"42029308200",2076,2695,619,0.229684601113173,0.770315398886827
"42029301900",3464,3551,87,0.0245001408054069,0.975499859194593
"42029307500",1959,2436,477,0.195812807881773,0.804187192118227
"42029302901",4215,4452,237,0.0532345013477089,0.946765498652291
"42029304600",3006,3148,142,0.0451080050825921,0.954891994917408
"42029305400",1235,2367,1132,0.478242501056189,0.521757498943811
"42029302902",5473,5813,340,0.0584895922931361,0.941510407706864
"42029302202",5602,6056,454,0.0749669749009247,0.925033025099075
"42029301800",2764,3131,367,0.117214947301182,0.882785052698818
"42029300302",3235,3542,307,0.0866741953698475,0.913325804630152
"42029300303",2551,2857,306,0.107105355267763,0.892894644732237
"4210115600",536,1989,1453,0.730517848164907,0.269482151835093
"4210115700",994,2759,1765,0.639724537876042,0.360275462123958
"4210115800",3486,5773,2287,0.396154512385242,0.603845487614758
"4210115900",1036,1779,743,0.417650365373806,0.582349634626194
"4210116000",4019,7385,3366,0.455788761002031,0.544211238997969
"4210116100",1688,5395,3707,0.687117701575533,0.312882298424467
"4210116200",612,2431,1819,0.748251748251748,0.251748251748252
"4210116300",943,3693,2750,0.74465204440834,0.25534795559166
"4210116400",1048,5078,4030,0.793619535250098,0.206380464749902
"4210116500",916,2713,1797,0.662366384076668,0.337633615923332
"4210116600",537,1471,934,0.63494221617947,0.36505778382053
"4210116700",2072,6886,4814,0.699099622422306,0.300900377577694
"4210116800",1379,4542,3163,0.696389255834434,0.303610744165566
"421013901",3497,6178,2681,0.433959210100356,0.566040789899644
"4210133100",6261,8884,2623,0.295249887438091,0.704750112561909
"4210133200",2216,2542,326,0.128245476003147,0.871754523996853
"4210133300",2901,3608,707,0.195953436807095,0.804046563192905
"4210133400",3053,4426,1373,0.310212381382738,0.689787618617262
"4210133500",2503,3447,944,0.273861328691616,0.726138671308384
"4210133600",4421,6355,1934,0.304327301337529,0.695672698662471
"4210133700",6665,9319,2654,0.284794505848267,0.715205494151733
"4210133800",4264,5974,1710,0.286240374958152,0.713759625041848
"4210133900",2252,2744,492,0.17930029154519,0.82069970845481
"4210134000",1801,2429,628,0.258542610127625,0.741457389872376
"4210134100",4495,5603,1108,0.197751204711762,0.802248795288238
"4210134200",2497,3054,557,0.182383759004584,0.817616240995416
"42091202500",3822,4333,511,0.117932148626817,0.882067851373183
"42091203602",2748,3645,897,0.246090534979424,0.753909465020576
"42091206300",3409,3683,274,0.0743958729296769,0.925604127070323
"42091204600",4271,4726,455,0.0962759204401185,0.903724079559882
"42091204101",3827,4715,888,0.188335100742312,0.811664899257688
"42091205700",3326,4370,1044,0.238901601830664,0.761098398169336
"42091203801",2713,3403,690,0.202762268586541,0.797237731413459
"42091203302",5707,6247,540,0.0864414919161197,0.91355850808388
"42091205809",2559,2781,222,0.0798274002157497,0.92017259978425
"42091201901",4280,4534,254,0.0560211733568593,0.943978826643141
"42091202100",3896,4471,575,0.128606575710132,0.871393424289868
"42091202402",4322,5087,765,0.150383330057008,0.849616669942992
"42091204701",2090,2239,149,0.0665475658776239,0.933452434122376
"42091207300",1989,2539,550,0.216620716817645,0.783379283182355
"42101100",2002,2409,407,0.168949771689498,0.831050228310502
"42101200",334,1223,889,0.726901062959935,0.273098937040065
"4210116902",2553,6554,4001,0.610466890448581,0.389533109551419
"4210116901",1158,3799,2641,0.695182942879705,0.304817057120295
"4210117000",1500,2858,1358,0.475157452764171,0.524842547235829
"4210117100",1888,4429,2541,0.573718672386543,0.426281327613457
"4210117200",3404,8502,5098,0.599623617972242,0.400376382027758
"4210117300",1247,3105,1858,0.598389694041868,0.401610305958132
"4210117400",760,2650,1890,0.713207547169811,0.286792452830189
"4210117500",1672,7408,5736,0.774298056155508,0.225701943844492
"4210117700",1950,9094,7144,0.785572905212228,0.214427094787772
"4210117800",1278,6316,5038,0.797656744775174,0.202343255224826
"4210117900",2906,6011,3105,0.516552986191981,0.483447013808019
"4210118000",5006,8005,2999,0.374640849469082,0.625359150530918
"42091201203",2404,2609,205,0.0785741663472595,0.921425833652741
"42091203106",1514,1697,183,0.107837360047142,0.892162639952858
"42091208204",2732,2985,253,0.0847571189279732,0.915242881072027
"42091206105",2767,2995,228,0.076126878130217,0.923873121869783
"42091206106",3952,4346,394,0.0906580763920847,0.909341923607915
"42091204004",2324,2749,425,0.154601673335758,0.845398326664242
"42091208801",759,1087,328,0.301747930082797,0.698252069917203
"42091207201",2049,2452,403,0.164355628058728,0.835644371941272
"42091200308",3435,3960,525,0.132575757575758,0.867424242424242
"42091203103",2735,2951,216,0.0731955269400203,0.92680447305998
"42091208000",2178,2597,419,0.161340007701194,0.838659992298806
"42101300",1507,1941,434,0.22359608449253,0.77640391550747
"42101400",2628,3944,1316,0.33367139959432,0.66632860040568
"42101500",147,522,375,0.718390804597701,0.281609195402299
"42101600",560,786,226,0.287531806615776,0.712468193384224
"42101700",1760,2550,790,0.309803921568627,0.690196078431373
"42101800",6514,8461,1947,0.230114643659142,0.769885356340858
"42101900",2321,4320,1999,0.462731481481481,0.537268518518519
"421011000",5198,5808,610,0.105027548209366,0.894972451790634
"421011100",4120,5896,1776,0.301221166892809,0.698778833107191
"421011200",6474,8042,1568,0.194976374036309,0.805023625963691
"421011300",2122,4384,2262,0.515967153284672,0.484032846715328
"421011400",1968,3501,1533,0.437874892887746,0.562125107112254
"421011500",1484,2167,683,0.315182279649285,0.684817720350715
"421011600",1557,1953,396,0.202764976958525,0.797235023041475
"4210118100",108,199,91,0.457286432160804,0.542713567839196
"4210118200",168,381,213,0.559055118110236,0.440944881889764
"4210118300",2802,4027,1225,0.304196672460889,0.695803327539111
"4210118400",1509,2239,730,0.326038410004466,0.673961589995534
"4210118500",84,117,33,0.282051282051282,0.717948717948718
"4210118600",3150,4851,1701,0.350649350649351,0.649350649350649
"4210118700",825,1584,759,0.479166666666667,0.520833333333333
"4210118800",2878,7226,4348,0.601716025463604,0.398283974536396
"42091200906",1629,1922,293,0.152445369406868,0.847554630593132
"42091201005",3554,3643,89,0.0244304144935493,0.975569585506451
"42091203601",1439,2737,1298,0.474241870661308,0.525758129338692
"42091207900",1883,2196,313,0.142531876138434,0.857468123861566
"42091206008",3958,4184,226,0.0540152963671128,0.945984703632887
"42091206701",5687,6456,769,0.119114002478315,0.880885997521685
"42091209202",1584,2233,649,0.29064039408867,0.70935960591133
"42091203500",4164,5825,1661,0.285150214592275,0.714849785407725
"42091207101",4440,4833,393,0.0813159528243327,0.918684047175667
"42091208500",4303,4748,445,0.0937236731255265,0.906276326874473
"42091210200",2523,2756,233,0.0845428156748912,0.915457184325109
"42091210400",3855,4593,738,0.160679294578707,0.839320705421293
"42091200502",4382,5522,1140,0.206446939514669,0.793553060485331
"42091208302",4610,4966,356,0.0716874748288361,0.928312525171164
"421011700",1916,2417,501,0.207281754240794,0.792718245759206
"421011800",1564,2456,892,0.363192182410423,0.636807817589577
"421011900",1005,2677,1672,0.62457975345536,0.37542024654464
"421012000",861,2245,1384,0.616481069042316,0.383518930957684
"421012100",1004,2374,1370,0.577085088458298,0.422914911541702
"421012200",978,2108,1130,0.536053130929791,0.463946869070209
"421012300",1441,2628,1187,0.451674277016743,0.548325722983257
"421012400",2536,4262,1726,0.404974190520882,0.595025809479118
"421012500",1526,3149,1623,0.515401714830105,0.484598285169895
"421012600",0,0,0,NA,NA
"421012700",3285,7595,4310,0.567478604344964,0.432521395655036
"421012800",3933,9242,5309,0.574442761307076,0.425557238692924
"421012900",2477,4050,1573,0.388395061728395,0.611604938271605
"421013000",2754,8143,5389,0.661795407098121,0.338204592901879
"421013100",1934,5150,3216,0.624466019417476,0.375533980582524
"4210118900",370,938,568,0.605543710021322,0.394456289978678
"4210119000",2719,6851,4132,0.60312363158663,0.39687636841337
"4210119100",4333,6626,2293,0.346060971928765,0.653939028071234
"4210119200",1875,7469,5594,0.748962377828357,0.251037622171643
"4210119300",139,146,7,0.0479452054794521,0.952054794520548
"4210119400",95,350,255,0.728571428571429,0.271428571428571
"4210119500",1538,8635,7097,0.821887666473654,0.178112333526346
"4210119600",563,2605,2042,0.783877159309021,0.216122840690979
"4210119700",2353,7119,4766,0.669476050007023,0.330523949992977
"4210119800",1808,6211,4403,0.708903558203188,0.291096441796812
"42091206009",424,452,28,0.0619469026548673,0.938053097345133
"42091205801",2255,2617,362,0.138326327856324,0.861673672143676
"42091206906",2954,3116,162,0.05198973042362,0.94801026957638
"42091206904",4578,5236,658,0.125668449197861,0.874331550802139
"42091201006",1726,1811,85,0.0469353948094975,0.953064605190503
"42091204300",2056,2380,324,0.136134453781513,0.863865546218487
"42091201100",2949,3327,378,0.113615870153291,0.886384129846709
"42091201004",4010,4256,246,0.0578007518796992,0.942199248120301
"42091200704",2858,3184,326,0.102386934673367,0.897613065326633
"42091203403",2609,2900,291,0.100344827586207,0.899655172413793
"42091200907",2318,2559,241,0.0941774130519734,0.905822586948027
"42091207004",3944,4380,436,0.0995433789954338,0.900456621004566
"42091204702",3101,3366,265,0.0787284610814023,0.921271538918598
"421013200",2265,5522,3257,0.58982252806954,0.41017747193046
"421013300",2737,6223,3486,0.560179977502812,0.439820022497188
"421013400",177,387,210,0.542635658914729,0.457364341085271
"421013500",41,117,76,0.64957264957265,0.35042735042735
"421013600",2304,5709,3405,0.596426694692591,0.403573305307409
"421013701",2817,7018,4201,0.5986035907666,0.4013964092334
"421013702",2039,3319,1280,0.385658330822537,0.614341669177463
"421014101",1975,5692,3717,0.653021784961349,0.346978215038651
"421014002",3649,5018,1369,0.27281785571941,0.72718214428059
"421013902",4379,5619,1240,0.220679836269799,0.779320163730201
"421014001",2331,4036,1705,0.422447968285431,0.577552031714569
"421014102",3399,7316,3917,0.535401858939311,0.464598141060689
"421014202",2948,4913,1965,0.399959291675148,0.600040708324852
"4210119900",1160,4971,3811,0.766646549989942,0.233353450010058
"4210120000",657,1346,689,0.511887072808321,0.488112927191679
"4210120100",3457,7683,4226,0.550045555121697,0.449954444878303
"4210120200",2434,5609,3175,0.566054555179176,0.433945444820824
"4210120300",1180,2995,1815,0.606010016694491,0.393989983305509
"4210120400",1559,3374,1815,0.537937166567872,0.462062833432128
"4210120500",1190,3280,2090,0.63719512195122,0.36280487804878
"4210120600",917,1612,695,0.431141439205955,0.568858560794045
"4210120700",3950,5281,1331,0.252035599318311,0.747964400681689
"4210120800",1447,1930,483,0.250259067357513,0.749740932642487
"4210120900",2189,2823,634,0.22458377612469,0.77541622387531
"4210121000",3587,4934,1347,0.273003648155655,0.726996351844345
"42091205200",2613,2856,243,0.0850840336134454,0.914915966386555
"42091208301",2030,2385,355,0.148846960167715,0.851153039832285
"42091200707",3249,3889,640,0.164566726664952,0.835433273335048
"42091206905",4457,4774,317,0.066401340594889,0.933598659405111
"42091206702",0,0,0,NA,NA
"42091208702",2935,3309,374,0.113025083106679,0.886974916893321
"42091208400",2516,2907,391,0.134502923976608,0.865497076023392
"42091200506",4283,4522,239,0.0528527200353826,0.947147279964617
"42091200309",2519,2686,167,0.0621742367833209,0.937825763216679
"42091200103",3278,3435,157,0.0457059679767103,0.95429403202329
"42091201201",4846,5176,330,0.0637557959814529,0.936244204018547
"42091207202",3338,4182,844,0.20181731229077,0.79818268770923
"42091200908",1655,2135,480,0.224824355971897,0.775175644028103
"421014300",0,0,0,NA,NA
"421014400",563,1110,547,0.492792792792793,0.507207207207207
"421014500",2386,3049,663,0.217448343719252,0.782551656280748
"421014600",39,177,138,0.779661016949153,0.220338983050847
"421014201",3206,5440,2234,0.410661764705882,0.589338235294118
"421014800",425,500,75,0.15,0.85
"421014900",0,0,0,NA,NA
"421015000",0,0,0,NA,NA
"421015100",340,554,214,0.386281588447653,0.613718411552347
"4210121100",2101,2574,473,0.183760683760684,0.816239316239316
"4210121200",1559,2360,801,0.339406779661017,0.660593220338983
"4210121300",2682,3654,972,0.266009852216749,0.733990147783251
"4210121400",2760,3964,1204,0.303733602421796,0.696266397578204
"4210121500",2670,3465,795,0.229437229437229,0.770562770562771
"4210121600",1563,1845,282,0.152845528455285,0.847154471544715
"4210121700",5001,5951,950,0.159637035792304,0.840362964207696
"4210121800",3365,4490,1125,0.250556792873051,0.749443207126949
"4210121900",1072,1198,126,0.105175292153589,0.894824707846411
"4210122000",1178,1405,227,0.161565836298932,0.838434163701068
"42091200602",5452,5964,512,0.0858484238765929,0.914151576123407
"42091206500",6384,7078,694,0.0980502966939814,0.901949703306019
"42091207001",5140,5907,767,0.129845945488404,0.870154054511596
"42091200604",7585,8158,573,0.0702378033831822,0.929762196616818
"42091208603",4600,4920,320,0.0650406504065041,0.934959349593496
"42091200703",3672,4070,398,0.0977886977886978,0.902211302211302
"42091201409",3910,4282,372,0.0868752919196637,0.913124708080336
"42091208100",2427,3076,649,0.210988296488947,0.789011703511053
"42091205808",4177,4463,286,0.0640824557472552,0.935917544252745
"42091206102",4621,5049,428,0.0847692612398495,0.91523073876015
"42091206005",4157,4688,531,0.113267918088737,0.886732081911263
"42091205903",2434,2526,92,0.0364212193190816,0.963578780680918
"42091205807",1812,2039,227,0.111329082883767,0.888670917116233
"42091200306",3415,3701,286,0.0772764117805998,0.9227235882194
"42091200305",1846,2033,187,0.0919822921790457,0.908017707820954
"42091200310",2782,3134,352,0.112316528398213,0.887683471601787
"421015200",0,0,0,NA,NA
"421015600",540,1241,701,0.564867042707494,0.435132957292506
"421015700",0,0,0,NA,NA
"421015800",0,0,0,NA,NA
"421015900",0,0,0,NA,NA
"421016000",3372,6051,2679,0.442736737729301,0.557263262270699
"421016100",1830,2908,1078,0.3707015130674,0.6292984869326
"421016200",1843,4125,2282,0.553212121212121,0.446787878787879
"421016300",1732,4526,2794,0.617322138753867,0.382677861246133
"4210122100",806,994,188,0.189134808853119,0.810865191146881
"4210122200",1531,1619,88,0.054354539839407,0.945645460160593
"4210122300",148,211,63,0.298578199052133,0.701421800947867
"4210122400",298,340,42,0.123529411764706,0.876470588235294
"4210122500",232,256,24,0.09375,0.90625
"4210122600",245,317,72,0.227129337539432,0.772870662460568
"4210122700",1101,1176,75,0.0637755102040816,0.936224489795918
"4210122800",1359,1558,199,0.127727856225931,0.872272143774069
"4210122900",338,338,0,0,1
"4210123000",344,421,77,0.182897862232779,0.817102137767221
"4210123100",1152,1227,75,0.0611246943765281,0.938875305623472
"4210123200",514,649,135,0.208012326656394,0.791987673343606
"42091201410",2273,2444,171,0.0699672667757774,0.930032733224223
"42091205100",1226,1702,476,0.279670975323149,0.720329024676851
"42091201404",4403,4828,425,0.0880281690140845,0.911971830985915
"42091203203",3863,4205,342,0.0813317479191439,0.918668252080856
"42091204400",2968,3234,266,0.0822510822510823,0.917748917748918
"42091206802",2258,2390,132,0.0552301255230126,0.944769874476987
"42091203207",2886,3199,313,0.0978430759612379,0.902156924038762
"42091203304",2757,3154,397,0.125871908687381,0.874128091312619
"42091208905",2357,2824,467,0.165368271954674,0.834631728045326
"42091208901",2442,3432,990,0.288461538461538,0.711538461538462
"42091201603",3779,4653,874,0.187835804857081,0.812164195142919
"421016400",1825,4642,2817,0.606850495476088,0.393149504523912
"421016500",2801,5161,2360,0.457275721759349,0.542724278240651
"421016600",1343,3851,2508,0.651259413139444,0.348740586860556
"421016700",2757,6927,4170,0.601992204417497,0.398007795582503
"421016800",0,0,0,NA,NA
"421016900",831,2638,1807,0.684988627748294,0.315011372251706
"421017000",1815,4556,2741,0.601624231782265,0.398375768217735
"421017100",3790,8175,4385,0.536391437308869,0.463608562691131
"421017200",2699,5387,2688,0.498979023575274,0.501020976424726
"421017300",1437,3251,1814,0.557982159335589,0.442017840664411
"421017400",1708,4530,2822,0.622958057395144,0.377041942604856
"4210123300",2390,3061,671,0.219209408689971,0.780790591310029
"4210123400",528,542,14,0.025830258302583,0.974169741697417
"4210123500",1145,1208,63,0.0521523178807947,0.947847682119205
"4210123600",2175,2412,237,0.0982587064676617,0.901741293532338
"4210123700",3603,4840,1237,0.255578512396694,0.744421487603306
"4210123800",3242,4534,1292,0.284958094397883,0.715041905602117
"4210123900",1098,2052,954,0.464912280701754,0.535087719298246
"4210124000",2351,4215,1864,0.442230130486358,0.557769869513642
"4210124100",457,1152,695,0.603298611111111,0.396701388888889
"4210124200",1991,4183,2192,0.524025818790342,0.475974181209658
"4210124300",2232,3993,1761,0.441021788129226,0.558978211870774
"4210124400",1982,3463,1481,0.427663875252671,0.572336124747329
"4210124500",1850,4359,2509,0.575590731819225,0.424409268180775
"4210124600",1199,2871,1672,0.582375478927203,0.417624521072797
"42091201204",1894,2185,291,0.133180778032037,0.866819221967963
"42091201604",2895,3339,444,0.132973944294699,0.867026055705301
"42091201608",4144,4575,431,0.094207650273224,0.905792349726776
"42091205000",1356,1839,483,0.262642740619902,0.737357259380098
"42091205502",2979,3281,302,0.0920451081987199,0.90795489180128
"42091201704",2937,3352,415,0.123806682577566,0.876193317422434
"42091202401",2142,3341,1199,0.358874588446573,0.641125411553427
"42091200106",1256,1536,280,0.182291666666667,0.817708333333333
"42091206006",1701,1868,167,0.0894004282655246,0.910599571734475
"42091200901",2866,3822,956,0.250130821559393,0.749869178440607
"421017500",0,0,0,NA,NA
"421017600",4,4,0,0,1
"421017700",476,1617,1141,0.705627705627706,0.294372294372294
"421017800",2680,4517,1837,0.40668585344255,0.59331414655745
"421017900",3129,4736,1607,0.339315878378378,0.660684121621622
"421018000",2099,4142,2043,0.493239980685659,0.506760019314341
"421018100",3938,8222,4284,0.521041109219168,0.478958890780832
"421018200",3769,7208,3439,0.477108768035516,0.522891231964484
"4210117601",824,5843,5019,0.85897655314051,0.14102344685949
"421018301",2355,3987,1632,0.409330323551543,0.590669676448457
"421018400",2051,4730,2679,0.566384778012685,0.433615221987315
"421018500",2987,6501,3514,0.540532225811414,0.459467774188586
"421018600",2568,6078,3510,0.577492596248766,0.422507403751234
"4210124700",2027,4709,2682,0.569547674665534,0.430452325334466
"4210124800",994,2094,1100,0.52531041069723,0.47468958930277
"4210124900",1731,3656,1925,0.526531728665208,0.473468271334792
"4210125000",460,851,391,0.459459459459459,0.540540540540541
"4210125100",1712,2176,464,0.213235294117647,0.786764705882353
"4210125200",3828,7260,3432,0.472727272727273,0.527272727272727
"4210125300",2680,4251,1571,0.369560103505058,0.630439896494942
"4210125400",3250,4278,1028,0.240299205236092,0.759700794763908
"4210125500",2201,2747,546,0.198762286130324,0.801237713869676
"4210125600",2276,2751,475,0.172664485641585,0.827335514358415
"4210125700",2859,3262,403,0.123543838136113,0.876456161863887
"4210125800",1293,1684,391,0.232185273159145,0.767814726840855
"4210125900",3884,5141,1257,0.244504960124489,0.755495039875511
"4210126000",2502,3033,531,0.175074183976261,0.824925816023739
"42091205600",3678,4233,555,0.131112686038271,0.868887313961729
"42091205503",4138,4496,358,0.0796263345195729,0.920373665480427
"42091205501",3231,3718,487,0.130984400215169,0.869015599784831
"42091205300",1301,1705,404,0.236950146627566,0.763049853372434
"42091203000",2263,2579,316,0.12252811167119,0.87747188832881
"42091210300",3214,3447,233,0.0675950101537569,0.932404989846243
"42091208903",1918,3014,1096,0.363636363636364,0.636363636363636
"42091204008",2429,2859,430,0.150402238544946,0.849597761455054
"42091200800",2182,2567,385,0.149980522010129,0.850019477989871
"42091206104",2391,2439,48,0.019680196801968,0.980319803198032
"42091200708",4688,5327,639,0.119954946498968,0.880045053501032
"421018700",2763,6684,3921,0.586624775583483,0.413375224416517
"421018800",750,4612,3862,0.837380745880312,0.162619254119688
"421018900",170,742,572,0.77088948787062,0.22911051212938
"421019000",914,2960,2046,0.691216216216216,0.308783783783784
"421019100",971,2720,1749,0.643014705882353,0.356985294117647
"421019200",1320,3125,1805,0.5776,0.4224
"421019300",1738,4603,2865,0.622420160764719,0.377579839235281
"421019400",1457,3871,2414,0.623611469904418,0.376388530095582
"421019500",1531,3576,2045,0.571868008948546,0.428131991051454
"421019600",2055,4487,2432,0.542010251838645,0.457989748161355
"421019700",40,40,0,0,1
"421019800",5524,7762,2238,0.288327750579747,0.711672249420253
"421019900",328,338,10,0.029585798816568,0.970414201183432
"4210110000",2644,4202,1558,0.370775821037601,0.629224178962399
"4210110100",3009,5748,2739,0.47651356993737,0.523486430062631
"4210110200",1324,3182,1858,0.583909490886235,0.416090509113765
"4210110300",1147,2477,1330,0.536939846588615,0.463060153411385
"4210126100",2363,3224,861,0.267059553349876,0.732940446650124
"4210126200",3347,4483,1136,0.253401739906313,0.746598260093687
"4210134801",3230,4269,1039,0.243382525181541,0.756617474818459
"4210126302",3776,5741,1965,0.342274865006096,0.657725134993904
"4210126400",4562,5914,1352,0.228610077781535,0.771389922218465
"4210126500",2829,4789,1960,0.409271246606807,0.590728753393193
"4210126600",4681,6897,2216,0.321299115557489,0.678700884442511
"4210126700",4378,6991,2613,0.373766270919754,0.626233729080246
"4210126800",2703,4551,1848,0.406064601186552,0.593935398813448
"4210126900",1649,2056,407,0.19795719844358,0.80204280155642
"4210127000",1792,2437,645,0.26466967583094,0.73533032416906
"4210127100",1755,2343,588,0.250960307298335,0.749039692701664
"4210127200",3205,4553,1348,0.296068526246431,0.703931473753569
"42091200105",2115,2291,176,0.0768223483195111,0.923177651680489
"42091210500",3597,3949,352,0.0891364902506964,0.910863509749304
"42091205805",2886,3132,246,0.078544061302682,0.921455938697318
"42091201003",3853,4346,493,0.1134376438104,0.8865623561896
"42091206007",4463,5156,693,0.134406516679597,0.865593483320403
"42091206801",4882,5345,463,0.086623012160898,0.913376987839102
"42091200902",1043,1262,219,0.173534072900158,0.826465927099842
"42091207400",2059,2349,290,0.123456790123457,0.876543209876543
"42091206202",1249,1611,362,0.224705152079454,0.775294847920546
"42091200903",3312,3995,683,0.170963704630788,0.829036295369212
"42091200605",4168,4595,427,0.0929270946681175,0.907072905331882
"42091205904",2024,2175,151,0.0694252873563218,0.930574712643678
"4210110400",1294,3475,2181,0.627625899280576,0.372374100719424
"4210110500",950,3273,2323,0.709746410021387,0.290253589978613
"4210110600",428,1494,1066,0.713520749665328,0.286479250334672
"4210110700",1244,3654,2410,0.659551176792556,0.340448823207444
"4210110800",1338,4238,2900,0.684285040113261,0.315714959886739
"4210110900",889,2556,1667,0.652190923317684,0.347809076682316
"4210111000",1310,3764,2454,0.651965993623804,0.348034006376196
"4210111100",1654,4125,2471,0.599030303030303,0.400969696969697
"4210111200",2523,6029,3506,0.581522640570576,0.418477359429424
"4210111300",1711,3126,1415,0.452655150351887,0.547344849648113
"4210111400",3815,6601,2786,0.422057264050901,0.577942735949099
"4210111500",3069,4241,1172,0.276349917472294,0.723650082527706
"4210111600",2024,3276,1252,0.382173382173382,0.617826617826618
"4210111700",908,1438,530,0.368567454798331,0.631432545201669
"4210127300",3125,5932,2807,0.473196223870533,0.526803776129467
"4210127400",5971,10366,4395,0.423982249662358,0.576017750337642
"4210127500",2652,4801,2149,0.447615080191627,0.552384919808373
"4210127600",2256,3857,1601,0.415089447757324,0.584910552242676
"4210127700",2523,5037,2514,0.499106611078023,0.500893388921977
"4210127800",2161,4849,2688,0.554341101257991,0.445658898742009
"4210127900",3147,6596,3449,0.522892662219527,0.477107337780473
"4210128000",2580,4790,2210,0.461377870563674,0.538622129436326
"4210128100",2530,3999,1469,0.367341835458865,0.632658164541135
"4210128200",2302,4812,2510,0.521612635078969,0.478387364921031
"4210128300",3048,7154,4106,0.573944646351691,0.426055353648309
"4210128400",2225,4357,2132,0.489327518935047,0.510672481064953
"42029300101",2810,2903,93,0.0320358250086118,0.967964174991388
"42091200501",3720,3865,145,0.03751617076326,0.96248382923674
"42091200507",4839,5298,459,0.0866364665911665,0.913363533408833
"42091201502",1730,1848,118,0.0638528138528139,0.936147186147186
"42091204007",1892,2252,360,0.159857904085258,0.840142095914742
"42091203402",5063,5520,457,0.0827898550724638,0.917210144927536
"42091205905",2754,3183,429,0.134778510838831,0.865221489161169
"42091200603",2879,3035,156,0.0514003294892916,0.948599670510708
"42091203401",5449,6310,861,0.136450079239303,0.863549920760697
"42091200401",2814,3438,624,0.181500872600349,0.818499127399651
"42091200200",1059,1211,152,0.125516102394715,0.874483897605285
"42091204200",1155,1442,287,0.199029126213592,0.800970873786408
"4210111800",4061,5959,1898,0.318509817083403,0.681490182916597
"4210111900",3184,5560,2376,0.427338129496403,0.572661870503597
"4210112000",1270,1690,420,0.248520710059172,0.751479289940828
"4210112100",1967,2813,846,0.30074653394952,0.69925346605048
"4210112200",4714,7820,3106,0.397186700767263,0.602813299232737
"4210112300",13,13,0,0,1
"4210112400",0,0,0,NA,NA
"4210112500",2457,3783,1326,0.350515463917526,0.649484536082474
"4210112600",378,752,374,0.497340425531915,0.502659574468085
"4210128500",1394,2300,906,0.393913043478261,0.606086956521739
"4210128600",3025,7294,4269,0.58527556896079,0.41472443103921
"4210128700",709,2502,1793,0.716626698641087,0.283373301358913
"4210128800",1456,4271,2815,0.659096230391009,0.340903769608991
"4210128900",3972,10030,6058,0.603988035892323,0.396011964107677
"4210129000",3795,6199,2404,0.387804484594289,0.612195515405711
"4210129100",2536,4352,1816,0.417279411764706,0.582720588235294
"4210129200",2404,4230,1826,0.431678486997636,0.568321513002364
"4210129300",819,2868,2049,0.714435146443515,0.285564853556485
"4210129400",1270,3213,1943,0.604730781201369,0.395269218798631
"4210129500",626,1050,424,0.403809523809524,0.596190476190476
"4210129600",620,1191,571,0.479429051217464,0.520570948782536
"4210134300",148,181,33,0.18232044198895,0.81767955801105
"4210134400",6181,7062,881,0.124752194845653,0.875247805154347
"4210134500",5079,8437,3358,0.398008770890127,0.601991229109873
"4210134600",1151,1803,652,0.361619523017194,0.638380476982806
"4210136303",6184,7092,908,0.128031584884377,0.871968415115623
"4210134701",4812,6078,1266,0.208292201382034,0.791707798617966
"4210134802",4185,5458,1273,0.233235617442287,0.766764382557714
"4210134900",3903,6578,2675,0.406658558832472,0.593341441167528
"4210135100",3489,4347,858,0.197377501725328,0.802622498274672
"42091201703",2825,3127,302,0.0965781899584266,0.903421810041573
"42091202301",4427,4856,429,0.0883443163097199,0.91165568369028
"42091203104",3439,3739,300,0.0802353570473389,0.919764642952661
"42091202602",2074,2238,164,0.0732797140303843,0.926720285969616
"42091201607",3205,3591,386,0.107490949596213,0.892509050403787
"42091201411",2164,2510,346,0.137848605577689,0.862151394422311
"42091203700",667,1047,380,0.362941738299905,0.637058261700095
"42091203902",1417,2830,1413,0.499293286219081,0.500706713780919
"42091203303",2826,3117,291,0.0933589990375361,0.906641000962464
"42091201705",3902,4538,636,0.140149845747025,0.859850154252975
"42091203803",3198,4967,1769,0.356150593919871,0.643849406080129
"42091204010",2526,2608,82,0.031441717791411,0.968558282208589
"42091209000",936,1540,604,0.392207792207792,0.607792207792208
"42091206201",2296,2604,308,0.118279569892473,0.881720430107527
"42091208601",3766,4062,296,0.0728705071393402,0.92712949286066
"42091206600",1077,1326,249,0.187782805429864,0.812217194570136
"4210112700",106,643,537,0.835147744945568,0.164852255054432
"4210112800",195,231,36,0.155844155844156,0.844155844155844
"4210112900",406,521,115,0.220729366602687,0.779270633397313
"4210113000",645,988,343,0.347165991902834,0.652834008097166
"4210113100",651,1726,1075,0.622827346465817,0.377172653534183
"4210113200",689,1983,1294,0.652546646495209,0.347453353504791
"4210113300",917,2178,1261,0.578971533516988,0.421028466483012
"4210113400",3757,5356,1599,0.298543689320388,0.701456310679612
"4210113500",1793,3336,1543,0.462529976019185,0.537470023980815
"4210113600",4682,5955,1273,0.213769941225861,0.786230058774139
"4210113700",2830,5161,2331,0.451656655686882,0.548343344313118
"4210113800",807,2205,1398,0.634013605442177,0.365986394557823
"4210113900",428,2427,1999,0.823650597445406,0.176349402554594
"4210114000",816,2744,1928,0.702623906705539,0.297376093294461
"4210114100",661,2197,1536,0.699135184342285,0.300864815657715
"4210129700",206,396,190,0.47979797979798,0.52020202020202
"4210129800",2497,4357,1860,0.426899242598118,0.573100757401882
"4210129900",1827,4415,2588,0.586183465458664,0.413816534541336
"4210130000",3243,7053,3810,0.540195661420672,0.459804338579328
"4210130100",3567,5873,2306,0.392644304444066,0.607355695555934
"4210130200",4812,6686,1874,0.280287167215076,0.719712832784924
"4210130300",3758,6831,3073,0.449860928121798,0.550139071878202
"4210130400",307,465,158,0.339784946236559,0.660215053763441
"4210130500",6491,10042,3551,0.353614817765385,0.646385182234615
"4210130600",4750,6341,1591,0.250906797035168,0.749093202964832
"4210130700",2061,2973,912,0.306760847628658,0.693239152371342
"4210135200",3529,4356,827,0.189853076216713,0.810146923783287
"4210135301",4467,5486,1019,0.185745534086766,0.814254465913234
"4210126301",3387,4303,916,0.212874738554497,0.787125261445503
"4210135400",0,5,5,1,0
"4210135500",5099,6786,1687,0.248600058944887,0.751399941055113
"4210135600",6294,8348,2054,0.246046957355055,0.753953042644945
"4210135700",5514,9015,3501,0.388352745424293,0.611647254575707
"4210135800",4986,5937,951,0.160181910055584,0.839818089944416
"4210135900",4195,5443,1248,0.22928532059526,0.77071467940474
"4210136000",2105,2640,535,0.202651515151515,0.797348484848485
"4210136100",3502,3900,398,0.102051282051282,0.897948717948718
"4210134702",3211,3769,558,0.148049880604935,0.851950119395065
"4210136202",5007,6315,1308,0.207125890736342,0.792874109263658
"421014700",2021,2476,455,0.183764135702746,0.816235864297254
"421013800",2780,3844,1064,0.276795005202914,0.723204994797086
"421018302",2207,4472,2265,0.506484794275492,0.493515205724508
"4210117602",674,3846,3172,0.824752990119605,0.175247009880395
"42091200307",2461,3088,627,0.203044041450777,0.796955958549223
"42091204900",4338,4572,234,0.0511811023622047,0.948818897637795
"42091205400",5470,5906,436,0.073823230612936,0.926176769387064
"42091204002",2569,3033,464,0.152983844378503,0.847016155621497
"42091204800",5006,5369,363,0.067610355745949,0.932389644254051
"42091200402",3380,3937,557,0.141478282956566,0.858521717043434
"42091202603",2932,3260,328,0.100613496932515,0.899386503067485
"42091202201",4151,4807,656,0.136467651341793,0.863532348658207
"42091201706",3787,4361,574,0.131621187800963,0.868378812199037
"42091203804",1728,2893,1165,0.402696163152437,0.597303836847563
"42091203901",1247,3072,1825,0.594075520833333,0.405924479166667
"42091204005",892,975,83,0.0851282051282051,0.914871794871795
"42091210100",3368,3833,465,0.121314896947561,0.878685103052439
"42091201408",4202,4627,425,0.0918521720337152,0.908147827966285
"42091201407",2000,2306,306,0.132697311361665,0.867302688638335
"42091206400",3075,3201,126,0.0393626991565136,0.960637300843486
"42091203205",2173,2388,215,0.0900335008375209,0.909966499162479
"42091207104",2143,2770,627,0.226353790613718,0.773646209386282
"42091207103",3444,3773,329,0.0871985157699443,0.912801484230056
"42091201301",2670,3107,437,0.140650144834245,0.859349855165755
"4210114200",1118,2091,973,0.465327594452415,0.534672405547585
"4210114300",1031,1466,435,0.296725784447476,0.703274215552524
"4210114400",1314,3189,1875,0.587958607714017,0.412041392285983
"4210114500",359,1460,1101,0.754109589041096,0.245890410958904
"4210114600",1400,2161,761,0.352151781582601,0.647848218417399
"4210114700",509,2184,1675,0.766941391941392,0.233058608058608
"4210114800",75,629,554,0.880763116057234,0.119236883942766
"4210114900",1904,4627,2723,0.588502269288956,0.411497730711044
"4210115000",52,108,56,0.518518518518518,0.481481481481482
"4210115100",2247,7998,5751,0.719054763690923,0.280945236309077
"4210115200",1420,5077,3657,0.720307268071696,0.279692731928304
"4210115300",865,3254,2389,0.734173325138291,0.265826674861709
"4210115400",356,558,202,0.362007168458781,0.637992831541219
"4210115500",546,2862,2316,0.809224318658281,0.190775681341719
"4210130800",3525,4433,908,0.204827430633882,0.795172569366118
"4210130900",2319,3491,1172,0.335720423947293,0.664279576052707
"4210131000",4242,5888,1646,0.279551630434783,0.720448369565217
"4210131100",5469,8367,2898,0.346360702760846,0.653639297239154
"4210131200",2474,4147,1673,0.403424162044852,0.596575837955148
"4210131300",3732,5844,2112,0.361396303901437,0.638603696098563
"4210131400",6459,10298,3839,0.37279083317149,0.62720916682851
"4210131500",7323,9448,2125,0.22491532599492,0.77508467400508
"4210131600",4424,5452,1028,0.188554658840792,0.811445341159208
"4210131700",4021,5470,1449,0.264899451553931,0.73510054844607
"4210131800",2513,3512,999,0.284453302961276,0.715546697038724
"4210131900",3227,4611,1384,0.300151810887009,0.699848189112991
"4210132000",4360,6199,1839,0.296660751734151,0.703339248265849
"4210136203",4673,5279,606,0.114794468649365,0.885205531350635
"4210135302",3692,4452,760,0.170709793351303,0.829290206648697
"4210136201",4263,5063,800,0.158009085522418,0.841990914477582
"4210136302",2974,3741,767,0.205025394279604,0.794974605720396
"4210136301",3147,3838,691,0.180041688379364,0.819958311620636
"4210136400",35,35,0,0,1
"4210136600",540,609,69,0.113300492610837,0.886699507389163
"4210134803",3375,4476,1101,0.24597855227882,0.75402144772118
"42091201605",2531,2855,324,0.113485113835377,0.886514886164623
"42091202000",2238,2577,339,0.131548311990687,0.868451688009313
"42091200505",4392,4790,398,0.0830897703549061,0.916910229645094
"42091201406",4224,4628,404,0.0872947277441659,0.912705272255834
"42091201501",2607,3101,494,0.159303450499839,0.840696549500161
"42091205806",1454,1761,307,0.174332765474162,0.825667234525838
"42091206004",3493,4159,666,0.160134647751863,0.839865352248137
"42091203208",2771,3099,328,0.105840593739916,0.894159406260084
"42091208703",3147,3717,570,0.153349475383374,0.846650524616626
"42091206901",3886,4379,493,0.112582781456954,0.887417218543046
"42091204009",1146,1337,191,0.142857142857143,0.857142857142857
"42091208906",2750,3825,1075,0.281045751633987,0.718954248366013
"42091208203",3157,3748,591,0.157684098185699,0.842315901814301
"42091208704",3039,4187,1148,0.274181991879627,0.725818008120373
"42091208604",4179,4511,332,0.0735978718687652,0.926402128131235
"4210132100",2000,3741,1741,0.465383587276129,0.534616412723871
"4210132200",70,183,113,0.617486338797814,0.382513661202186
"4210132300",2517,3601,1084,0.301027492363232,0.698972507636768
"4210132400",15,15,0,0,1
"4210132500",3470,5285,1815,0.343424787133396,0.656575212866604
"4210132600",4501,6484,1983,0.305829734731647,0.694170265268353
"4210132700",70,197,127,0.644670050761421,0.355329949238579
"4210132800",3,3,0,0,1
"4210132900",2600,3900,1300,0.333333333333333,0.666666666666667
"4210133000",4890,7169,2279,0.31789649881434,0.68210350118566
"42091203204",5372,5681,309,0.054391832423869,0.945608167576131
"42091204102",2047,2864,817,0.285265363128492,0.714734636871508
"42091205906",1832,1961,129,0.0657827638959714,0.934217236104029
"42091200301",4951,6071,1120,0.184483610607808,0.815516389392192
"42091200104",3754,3913,159,0.0406337848198313,0.959366215180169
"42091208201",2087,2406,319,0.132585203657523,0.867414796342477
"42091208904",1650,2790,1140,0.408602150537634,0.591397849462366
"42091207003",2248,2532,284,0.11216429699842,0.88783570300158
"42091201800",2725,2973,248,0.0834174234779684,0.916582576522032
"42091201606",2256,2713,457,0.168448212311095,0.831551787688905
"42091202604",2083,2253,170,0.0754549489569463,0.924545051043054
"42091202302",2300,2434,134,0.0550534100246508,0.944946589975349
"42091203105",4998,5365,367,0.0684063373718546,0.931593662628145
"42091201902",5076,5675,599,0.105550660792952,0.894449339207048
"42091202202",2487,2938,451,0.153505786249149,0.846494213750851
"42091209100",3711,4097,386,0.094215279472785,0.905784720527215
"42091204500",4255,4498,243,0.0540240106714095,0.945975989328591
"42091208802",2396,2944,548,0.186141304347826,0.813858695652174
"42091207500",2809,3022,213,0.0704831237590999,0.9295168762409
"42091201302",2317,3069,752,0.245030954708374,0.754969045291626
"42091207800",4356,4857,501,0.103150092649784,0.896849907350216
