"GEOID","tot200_a","univ_a","tot199_a","li_a","hi_a"
"34005700102",2615,2896,281,0.0970303867403315,0.902969613259669
"34005700103",2021,2266,245,0.108120035304501,0.891879964695499
"34005700104",1415,1894,479,0.252903907074974,0.747096092925026
"34005700200",2503,2674,171,0.0639491398653702,0.93605086013463
"34005700301",811,1005,194,0.193034825870647,0.806965174129353
"34005700303",1121,1171,50,0.0426985482493595,0.957301451750641
"34005700304",2293,2439,146,0.0598605986059861,0.940139401394014
"34005700305",4272,4687,415,0.0885427778963089,0.911457222103691
"34005700306",2715,2801,86,0.0307033202427704,0.96929667975723
"34005700307",2273,2357,84,0.0356385235468816,0.964361476453118
"34005700401",1890,2059,169,0.082078678970374,0.917921321029626
"34005700402",2910,3378,468,0.13854351687389,0.86145648312611
"34005700403",3665,4284,619,0.144491129785247,0.855508870214753
"34005700405",1633,1784,151,0.0846412556053812,0.915358744394619
"34005700406",6204,7378,1174,0.15912171320141,0.84087828679859
"34005700501",4692,5184,492,0.0949074074074074,0.905092592592593
"34005700502",1858,2053,195,0.094982951777886,0.905017048222114
"34005700503",3158,3554,396,0.111423747889702,0.888576252110298
"34005700504",2359,2732,373,0.136530014641288,0.863469985358712
"34005700505",2072,2148,76,0.0353817504655493,0.964618249534451
"34005700602",2719,2947,228,0.0773668137088565,0.922633186291144
"34005700603",3275,3659,384,0.104946706750478,0.895053293249522
"34005700604",835,1241,406,0.327155519742143,0.672844480257857
"34005700605",5017,5308,291,0.0548229088168802,0.94517709118312
"34005700701",2792,3176,384,0.120906801007557,0.879093198992443
"34005700702",1712,2237,525,0.234689316048279,0.765310683951721
"34005700703",2087,2546,459,0.180282796543598,0.819717203456402
"34005700800",2863,3316,453,0.136610373944511,0.863389626055489
"34005700900",2226,3114,888,0.285163776493256,0.714836223506744
"34005701001",3663,4554,891,0.195652173913043,0.804347826086957
"34005701002",3551,3648,97,0.0265899122807018,0.973410087719298
"34005701102",1191,1330,139,0.104511278195489,0.895488721804511
"34005701103",2310,2894,584,0.201796821008984,0.798203178991016
"34005701104",3616,4331,715,0.165088894019857,0.834911105980143
"34005701105",2689,3120,431,0.138141025641026,0.861858974358974
"34005701201",2261,2798,537,0.19192280200143,0.80807719799857
"34005701203",1520,1895,375,0.197889182058047,0.802110817941952
"34005701204",1758,2806,1048,0.373485388453314,0.626514611546686
"34005701205",1745,2297,552,0.240313452329125,0.759686547670875
"34005701301",3978,4817,839,0.174174797591862,0.825825202408138
"34005701302",2165,2584,419,0.162151702786378,0.837848297213622
"34005701303",2250,2822,572,0.202693125442948,0.797306874557052
"34005701400",3361,3867,506,0.13085078872511,0.86914921127489
"34005701501",3869,4264,395,0.0926360225140713,0.907363977485929
"34005701502",2956,3271,315,0.0963008254356466,0.903699174564353
"34005701600",456,570,114,0.2,0.8
"34005701700",3572,4318,746,0.17276516905975,0.82723483094025
"34005701800",2489,2788,299,0.107245337159254,0.892754662840746
"34005701900",3385,4472,1087,0.243067978533095,0.756932021466905
"34005702000",468,754,286,0.379310344827586,0.620689655172414
"34005702101",2863,5568,2705,0.485811781609195,0.514188218390805
"34005702102",782,1081,299,0.276595744680851,0.723404255319149
"34005702103",1143,2745,1602,0.583606557377049,0.416393442622951
"34005702104",668,1194,526,0.440536013400335,0.559463986599665
"34005702105",1872,3207,1335,0.416276894293732,0.583723105706268
"34005702203",3440,4023,583,0.144916728809346,0.855083271190654
"34005702204",1149,1963,814,0.414671421293938,0.585328578706062
"34005702205",6102,7714,1612,0.208970702618616,0.791029297381384
"34005702206",1475,2010,535,0.266169154228856,0.733830845771144
"34005702207",3180,4079,899,0.220397156165727,0.779602843834273
"34005702208",6499,7692,1193,0.155096203848154,0.844903796151846
"34005702300",992,1363,371,0.272193690388848,0.727806309611152
"34005702400",2367,2790,423,0.151612903225806,0.848387096774194
"34005702500",4364,4957,593,0.119628807746621,0.880371192253379
"34005702601",3848,4518,670,0.14829570606463,0.85170429393537
"34005702602",718,1001,283,0.282717282717283,0.717282717282717
"34005702603",1631,2512,881,0.350716560509554,0.649283439490446
"34005702604",1103,2329,1226,0.526406182911121,0.473593817088879
"34005702700",5433,5873,440,0.0749191214030308,0.925080878596969
"34005702801",2282,2551,269,0.105448843590749,0.894551156409251
"34005702802",3429,3995,566,0.141677096370463,0.858322903629537
"34005702803",4142,4526,384,0.0848431285903668,0.915156871409633
"34005702804",2708,3145,437,0.138950715421304,0.861049284578696
"34005702805",3608,4302,694,0.161320316132032,0.838679683867968
"34005702806",3813,4399,586,0.133212093657649,0.86678790634235
"34005702807",2661,3088,427,0.138277202072539,0.861722797927461
"34005702808",3279,3959,680,0.171760545592321,0.828239454407679
"34005702809",1243,1391,148,0.106398274622574,0.893601725377426
"34005702810",1362,1587,225,0.141776937618147,0.858223062381853
"34005702811",3055,3197,142,0.044416640600563,0.955583359399437
"34005702903",14076,15351,1275,0.0830564784053156,0.916943521594684
"34005702904",7975,8497,522,0.0614334470989761,0.938566552901024
"34005702905",3997,4199,202,0.0481066920695404,0.95189330793046
"34005702906",1576,1786,210,0.117581187010078,0.882418812989922
"34005703000",2824,3220,396,0.122981366459627,0.877018633540373
"34005703101",3286,3876,590,0.152218782249742,0.847781217750258
"34005703102",2482,2693,211,0.0783512810991459,0.921648718900854
"34005703201",3022,3824,802,0.209728033472803,0.790271966527197
"34005703202",2191,2379,188,0.0790248003362757,0.920975199663724
"34005703203",3430,3991,561,0.140566274116763,0.859433725883237
"34005703300",993,1229,236,0.192026037428804,0.807973962571196
"34005703400",1292,1576,284,0.180203045685279,0.819796954314721
"34005703500",637,786,149,0.189567430025445,0.810432569974555
"34005703600",6816,7360,544,0.0739130434782609,0.926086956521739
"34005703700",5305,5695,390,0.0684811237928007,0.931518876207199
"34005703801",5205,5516,311,0.0563814358230602,0.94361856417694
"34005703802",2888,3242,354,0.10919185687847,0.89080814312153
"34005703803",5083,5414,331,0.0611377909124492,0.938862209087551
"34005703804",5982,6156,174,0.0282651072124756,0.971734892787524
"34005703900",4110,4342,232,0.053431598341778,0.946568401658222
"34005704003",6877,7207,330,0.0457888164284723,0.954211183571528
"34005704004",2931,3487,556,0.159449383424147,0.840550616575853
"34005704005",3637,3890,253,0.065038560411311,0.934961439588689
"34005704006",2256,2346,90,0.0383631713554987,0.961636828644501
"34005704007",2702,2989,287,0.0960187353629977,0.903981264637002
"34005704008",4371,4563,192,0.042077580539119,0.957922419460881
"34005704009",2160,2358,198,0.083969465648855,0.916030534351145
"34005704010",7887,8287,400,0.0482683721491493,0.951731627850851
"34005704100",401,573,172,0.300174520069808,0.699825479930192
"34005708400",70,70,0,0,1
"34007600100",49,283,234,0.826855123674912,0.173144876325088
"34007600200",1050,2969,1919,0.646345570899293,0.353654429100707
"34007600300",1186,4017,2831,0.704754792133433,0.295245207866567
"34007600400",1769,4408,2639,0.598684210526316,0.401315789473684
"34007600500",134,815,681,0.83558282208589,0.16441717791411
"34007600600",198,549,351,0.639344262295082,0.360655737704918
"34007600700",641,1998,1357,0.679179179179179,0.320820820820821
"34007600800",993,5916,4923,0.832150101419878,0.167849898580122
"34007600900",1199,4580,3381,0.7382096069869,0.2617903930131
"34007601000",2962,5440,2478,0.455514705882353,0.544485294117647
"34007601100",3687,9969,6282,0.630153475774902,0.369846524225098
"34007601200",2998,6419,3421,0.53294905748559,0.46705094251441
"34007601300",2327,6543,4216,0.644352743389882,0.355647256610118
"34007601400",2830,5555,2725,0.490549054905491,0.509450945094509
"34007601500",3266,6703,3437,0.512755482619722,0.487244517380278
"34007601600",1161,2572,1411,0.548600311041991,0.451399688958009
"34007601700",876,3388,2512,0.741440377804014,0.258559622195986
"34007601800",404,2079,1675,0.805675805675806,0.194324194324194
"34007601900",1669,4156,2487,0.598411934552454,0.401588065447546
"34007602000",3525,5310,1785,0.336158192090395,0.663841807909604
"34007602501",0,0,0,NA,NA
"34007602502",940,1120,180,0.160714285714286,0.839285714285714
"34007602503",2159,2600,441,0.169615384615385,0.830384615384615
"34007602601",2106,2649,543,0.204983012457531,0.795016987542469
"34007602602",2059,2522,463,0.183584456780333,0.816415543219667
"34007602701",39,44,5,0.113636363636364,0.886363636363636
"34007602702",2973,3917,944,0.241000765892264,0.758999234107736
"34007602703",1739,2115,376,0.177777777777778,0.822222222222222
"34007602800",2217,2780,563,0.202517985611511,0.797482014388489
"34007602901",4022,4879,857,0.17565074810412,0.82434925189588
"34007602902",2490,3303,813,0.24613987284287,0.75386012715713
"34007603001",3471,3794,323,0.0851344227727992,0.914865577227201
"34007603002",3652,4538,886,0.195240193918026,0.804759806081975
"34007603100",3186,4054,868,0.214109521460286,0.785890478539714
"34007603200",4902,5710,808,0.141506129597198,0.858493870402802
"34007603301",4051,4946,895,0.180954306510311,0.819045693489689
"34007603302",5833,6460,627,0.0970588235294118,0.902941176470588
"34007603303",2040,2562,522,0.203747072599532,0.796252927400468
"34007603400",6809,7356,547,0.0743610657966286,0.925638934203371
"34007603501",4385,4691,306,0.0652312939671712,0.934768706032829
"34007603502",11893,12538,645,0.0514436114212793,0.948556388578721
"34007603503",5318,5497,179,0.0325632162997999,0.9674367837002
"34007603504",2596,2764,168,0.060781476121563,0.939218523878437
"34007603505",3152,3414,262,0.0767428236672525,0.923257176332748
"34007603601",3443,3679,236,0.0641478662680076,0.935852133731992
"34007603602",2593,2723,130,0.0477414616232097,0.95225853837679
"34007603603",2252,2377,125,0.0525872949095499,0.94741270509045
"34007603700",3047,3544,497,0.140237020316027,0.859762979683973
"34007603800",4646,5191,545,0.104989404738971,0.895010595261029
"34007603901",4303,5096,793,0.155612244897959,0.844387755102041
"34007603902",2435,2856,421,0.147408963585434,0.852591036414566
"34007604000",1429,1672,243,0.145334928229665,0.854665071770335
"34007604100",1646,2522,876,0.347343378271213,0.652656621728787
"34007604200",3024,3632,608,0.167400881057269,0.832599118942731
"34007604300",3388,4017,629,0.156584515807817,0.843415484192183
"34007604400",3134,3458,324,0.0936957779063042,0.906304222093696
"34007604500",2716,4042,1326,0.328055418109847,0.671944581890153
"34007604600",1921,2277,356,0.156346069389548,0.843653930610452
"34007604700",1900,2147,247,0.115044247787611,0.884955752212389
"34007604800",884,1147,263,0.229293809938971,0.770706190061029
"34007604900",2462,3257,795,0.244089653054959,0.755910346945041
"34007605000",1761,2627,866,0.329653597259231,0.670346402740769
"34007605100",1984,2464,480,0.194805194805195,0.805194805194805
"34007605200",2226,3231,1005,0.311049210770659,0.688950789229341
"34007605300",1306,1581,275,0.173940543959519,0.826059456040481
"34007605400",2393,2762,369,0.133598841419261,0.866401158580739
"34007605500",1492,1755,263,0.14985754985755,0.85014245014245
"34007605601",1962,2288,326,0.142482517482517,0.857517482517482
"34007605602",2813,3049,236,0.0774024270252542,0.922597572974746
"34007605700",3247,3862,615,0.159243915069912,0.840756084930088
"34007605800",2755,3056,301,0.0984947643979058,0.901505235602094
"34007605900",2373,2828,455,0.160891089108911,0.839108910891089
"34007606000",1583,1963,380,0.193581253183902,0.806418746816098
"34007606100",2175,2274,99,0.0435356200527705,0.95646437994723
"34007606200",3647,3917,270,0.0689303038039316,0.931069696196068
"34007606300",1859,2135,276,0.129274004683841,0.870725995316159
"34007606400",3024,3174,150,0.0472589792060491,0.952741020793951
"34007606500",2195,2833,638,0.225202965054712,0.774797034945288
"34007606600",2222,2511,289,0.115093588211868,0.884906411788132
"34007606700",3530,4156,626,0.150625601539942,0.849374398460058
"34007606800",3472,4121,649,0.157486047075952,0.842513952924048
"34007606901",2657,3074,417,0.135653871177619,0.864346128822381
"34007606902",53,53,0,0,1
"34007607000",4351,5333,982,0.184136508531783,0.815863491468217
"34007607100",3445,4076,631,0.154808635917566,0.845191364082434
"34007607200",3765,5032,1267,0.251788553259142,0.748211446740858
"34007607300",3838,4842,1004,0.207352333746386,0.792647666253614
"34007607401",2644,3167,523,0.165140511525103,0.834859488474897
"34007607402",2001,2243,242,0.107891217119929,0.892108782880071
"34007607500",21485,23586,2101,0.0890782667684219,0.910921733231578
"34007607600",2090,2370,280,0.118143459915612,0.881856540084388
"34007607700",7544,9602,2058,0.214330347844199,0.785669652155801
"34007607800",7150,9047,1897,0.209682767768321,0.790317232231679
"34007607900",1834,2324,490,0.210843373493976,0.789156626506024
"34007608001",2748,3375,627,0.185777777777778,0.814222222222222
"34007608002",3737,4057,320,0.0788760167611536,0.921123983238846
"34007608100",744,1073,329,0.306616961789376,0.693383038210624
"34007608201",7524,8134,610,0.0749938529628719,0.925006147037128
"34007608202",4172,4582,410,0.0894805761676124,0.910519423832388
"34007608204",46,143,97,0.678321678321678,0.321678321678322
"34007608298",13178,15164,1986,0.130968082300185,0.869031917699815
"34007608301",6481,7668,1187,0.154799165362546,0.845200834637454
"34007608302",4070,5009,939,0.187462567378718,0.812537432621282
"34007608400",10891,12566,1675,0.133296196084673,0.866703803915327
"34007608500",7981,9809,1828,0.186359465796717,0.813640534203283
"34007608600",3916,5553,1637,0.29479560597875,0.70520439402125
"34007608700",4539,5643,1104,0.195640616693248,0.804359383306752
"34007608800",4341,5431,1090,0.20069968698214,0.79930031301786
"34007608901",4679,5504,825,0.149890988372093,0.850109011627907
"34007608903",3344,3733,389,0.104205732654701,0.895794267345299
"34007608904",1343,1508,165,0.109416445623342,0.890583554376658
"34007609000",1034,1508,474,0.314323607427056,0.685676392572944
"34007609101",7403,9193,1790,0.194713368867617,0.805286631132383
"34007609102",306,418,112,0.267942583732057,0.732057416267943
"34007609200",15256,19230,3974,0.20665626625065,0.79334373374935
"34007610100",0,18,18,1,0
"34007610200",808,1221,413,0.338247338247338,0.661752661752662
"34007610300",0,0,0,NA,NA
"34007610400",16,16,0,0,1
"34015500100",3655,4548,893,0.196350043975374,0.803649956024626
"34015500201",2538,2951,413,0.139952558454761,0.860047441545239
"34015500202",4052,5165,1113,0.215488867376573,0.784511132623427
"34015500203",4201,4652,451,0.0969475494411006,0.903052450558899
"34015500204",3467,3929,462,0.117587172308475,0.882412827691525
"34015500205",2008,2497,489,0.195835002002403,0.804164997997597
"34015500300",2422,3371,949,0.281518837140314,0.718481162859686
"34015500400",3708,6535,2827,0.432593726090283,0.567406273909717
"34015500500",4456,5179,723,0.139602239814636,0.860397760185364
"34015500600",4502,5045,543,0.107631318136769,0.892368681863231
"34015500701",3634,4347,713,0.164021164021164,0.835978835978836
"34015500702",3913,4297,384,0.0893646730276937,0.910635326972306
"34015500703",1266,1430,164,0.114685314685315,0.885314685314685
"34015500800",2185,2331,146,0.0626340626340626,0.937365937365937
"34015500900",3016,3385,369,0.109010339734121,0.890989660265879
"34015501001",1716,2176,460,0.211397058823529,0.788602941176471
"34015501002",2461,4287,1826,0.425938885001166,0.574061114998834
"34015501003",3116,3976,860,0.216297786720322,0.783702213279678
"34015501101",3201,3935,734,0.186531130876747,0.813468869123253
"34015501102",2279,2507,228,0.0909453530115676,0.909054646988432
"34015501103",2996,3540,544,0.153672316384181,0.846327683615819
"34015501104",2849,3247,398,0.122574684323991,0.877425315676009
"34015501105",2012,2450,438,0.178775510204082,0.821224489795918
"34015501106",2211,2801,590,0.210639057479472,0.789360942520528
"34015501107",4263,5157,894,0.173356602675974,0.826643397324026
"34015501201",4249,4389,140,0.0318979266347687,0.968102073365231
"34015501202",4990,5382,392,0.0728353771832033,0.927164622816797
"34015501203",3489,3745,256,0.0683578104138852,0.931642189586115
"34015501204",3876,4300,424,0.0986046511627907,0.901395348837209
"34015501205",1499,1793,294,0.163970998326827,0.836029001673174
"34015501206",3329,3613,284,0.0786050373650706,0.921394962634929
"34015501207",9767,10874,1107,0.101802464594445,0.898197535405555
"34015501208",2675,2871,196,0.0682688958551027,0.931731104144897
"34015501298",4184,4793,609,0.127060296265387,0.872939703734613
"34015501301",3226,3662,436,0.119060622610595,0.880939377389405
"34015501302",2441,3103,662,0.213341927167258,0.786658072832742
"34015501303",2060,2337,277,0.118528027385537,0.881471972614463
"34015501401",4568,5539,971,0.175302401155443,0.824697598844557
"34015501402",2154,3419,1265,0.369991225504534,0.630008774495467
"34015501403",2135,3151,1016,0.322437321485243,0.677562678514757
"34015501404",956,1584,628,0.396464646464646,0.603535353535354
"34015501500",4481,6109,1628,0.266492060893763,0.733507939106237
"34015501603",4025,5265,1240,0.235517568850902,0.764482431149098
"34015501604",4323,5437,1114,0.204892403899209,0.795107596100791
"34015501605",2714,3469,755,0.217641971749784,0.782358028250216
"34015501606",5284,6098,814,0.133486388979993,0.866513611020007
"34015501607",4879,6132,1253,0.204337899543379,0.795662100456621
"34015501701",2822,3805,983,0.258344283837056,0.741655716162944
"34015501702",2061,2510,449,0.178884462151394,0.821115537848606
"34015501703",3107,4174,1067,0.25563009103977,0.74436990896023
"34015501704",3029,3952,923,0.233552631578947,0.766447368421053
"34015501800",1396,1590,194,0.122012578616352,0.877987421383648
"34015501900",2981,3760,779,0.20718085106383,0.79281914893617
"34015502000",4034,4700,666,0.141702127659574,0.858297872340426
"34015502100",1657,1909,252,0.13200628601362,0.86799371398638
"34015502200",1165,1465,300,0.204778156996587,0.795221843003413
"34015502300",1495,2015,520,0.258064516129032,0.741935483870968
"34015502400",4586,5113,527,0.103070604341874,0.896929395658126
"34015502500",0,0,0,NA,NA
"34021000100",1695,2817,1122,0.398296059637913,0.601703940362087
"34021000200",2332,3044,712,0.233902759526938,0.766097240473062
"34021000300",2958,3532,574,0.162514156285391,0.837485843714609
"34021000400",2996,4144,1148,0.277027027027027,0.722972972972973
"34021000500",2535,3216,681,0.211753731343284,0.788246268656716
"34021000600",3043,3538,495,0.139909553420011,0.860090446579989
"34021000700",1640,2076,436,0.210019267822736,0.789980732177264
"34021000800",1448,2231,783,0.350963693411026,0.649036306588973
"34021000900",1932,4494,2562,0.570093457943925,0.429906542056075
"34021001000",1105,3094,1989,0.642857142857143,0.357142857142857
"34021001100",3773,6955,3182,0.457512580877067,0.542487419122933
"34021001200",3517,4386,869,0.19813041495668,0.80186958504332
"34021001300",3188,3778,590,0.156167284277395,0.843832715722605
"34021001400",3873,7910,4037,0.510366624525917,0.489633375474083
"34021001500",1512,3487,1975,0.56638944651563,0.43361055348437
"34021001600",786,1459,673,0.461274845784784,0.538725154215216
"34021001700",2524,5176,2652,0.512364760432767,0.487635239567233
"34021001800",2340,3485,1145,0.328550932568149,0.671449067431851
"34021001900",1010,2164,1154,0.533271719038817,0.466728280961183
"34021002000",458,1777,1319,0.742262239729882,0.257737760270118
"34021002100",3314,6108,2794,0.45743287491814,0.54256712508186
"34021002200",4056,6143,2087,0.33973628520267,0.66026371479733
"34021002300",0,0,0,NA,NA
"34021002400",0,0,0,NA,NA
"34021002500",5605,6498,893,0.137426900584795,0.862573099415205
"34021002600",6707,8092,1385,0.171156697973307,0.828843302026693
"34021002700",8566,10073,1507,0.149607862602998,0.850392137397002
"34021002800",4693,5757,1064,0.184818481848185,0.815181518151815
"34021002901",8330,9054,724,0.079964656505412,0.920035343494588
"34021002902",3682,4554,872,0.191480017566974,0.808519982433026
"34021003001",4633,5070,437,0.0861932938856016,0.913806706114398
"34021003002",5777,6040,263,0.0435430463576159,0.956456953642384
"34021003003",6028,6498,470,0.0723299476762081,0.927670052323792
"34021003004",5242,5559,317,0.0570246447202734,0.942975355279727
"34021003006",5967,6138,171,0.0278592375366569,0.972140762463343
"34021003007",3411,3543,132,0.0372565622353937,0.962743437764606
"34021003008",4133,4544,411,0.0904489436619718,0.909551056338028
"34021003009",4283,4492,209,0.0465271593944791,0.953472840605521
"34021003100",3096,3547,451,0.12714970397519,0.87285029602481
"34021003200",8697,9731,1034,0.106258349604357,0.893741650395643
"34021003300",9361,10136,775,0.0764601420678769,0.923539857932123
"34021003400",2211,2887,676,0.234153100103914,0.765846899896086
"34021003500",5449,6708,1259,0.187686344663089,0.812313655336911
"34021003601",2864,3188,324,0.101631116687578,0.898368883312422
"34021003602",2798,3231,433,0.134014237078304,0.865985762921696
"34021003701",8246,8749,503,0.0574922848325523,0.942507715167448
"34021003702",5278,5814,536,0.0921912624699002,0.9078087375301
"34021003800",5517,5810,293,0.0504302925989673,0.949569707401033
"34021003901",5088,5319,231,0.0434292160180485,0.956570783981952
"34021003902",1753,1969,216,0.109700355510411,0.890299644489589
"34021003903",2447,2532,85,0.0335703001579779,0.966429699842022
"34021004000",3235,4020,785,0.195273631840796,0.804726368159204
"34021004100",2424,2988,564,0.188755020080321,0.811244979919679
"34021004201",5164,6068,904,0.148978246539222,0.851021753460778
"34021004202",6171,7151,980,0.137043770102084,0.862956229897916
"34021004301",2382,3190,808,0.253291536050157,0.746708463949843
"34021004304",3893,3959,66,0.0166708764839606,0.983329123516039
"34021004305",8623,8860,237,0.0267494356659142,0.973250564334086
"34021004398",5206,5788,582,0.100552868002764,0.899447131997236
"34021004401",9924,10935,1011,0.0924554183813443,0.907544581618656
"34021004403",4575,5032,457,0.090818759936407,0.909181240063593
"34021004404",6965,7700,735,0.0954545454545455,0.904545454545455
"34021004405",3311,3632,321,0.0883810572687225,0.911618942731278
"42017100101",7626,10198,2572,0.252206314963718,0.747793685036282
"42017100102",2072,2496,424,0.169871794871795,0.830128205128205
"42017100201",3523,4375,852,0.194742857142857,0.805257142857143
"42017100205",9882,10659,777,0.0728961441035745,0.927103855896426
"42017100206",3870,4268,398,0.0932521087160262,0.906747891283974
"42017100207",2472,3409,937,0.274860662951012,0.725139337048988
"42017100208",4534,6051,1517,0.250702363245745,0.749297636754255
"42017100209",6272,7498,1226,0.163510269405175,0.836489730594825
"42017100210",6356,7242,886,0.122341894504281,0.877658105495719
"42017100302",4025,5288,1263,0.238842662632375,0.761157337367625
"42017100303",3802,5372,1570,0.292256142963515,0.707743857036485
"42017100304",1610,2343,733,0.31284677763551,0.68715322236449
"42017100305",6616,8384,1768,0.21087786259542,0.78912213740458
"42017100401",5148,6485,1337,0.206168080185042,0.793831919814958
"42017100402",6305,7072,767,0.108455882352941,0.891544117647059
"42017100403",1852,2432,580,0.238486842105263,0.761513157894737
"42017100404",6066,6969,903,0.129573826947912,0.870426173052088
"42017100405",7861,8962,1101,0.122852041954921,0.877147958045079
"42017100406",3053,3560,507,0.142415730337079,0.857584269662921
"42017100500",2233,2774,541,0.195025234318673,0.804974765681327
"42017100600",2741,3847,1106,0.287496750714843,0.712503249285157
"42017100700",2462,3634,1172,0.322509631260319,0.677490368739681
"42017100802",6477,7642,1165,0.152447003402251,0.847552996597749
"42017100803",4688,5214,526,0.100882240122746,0.899117759877254
"42017100804",3420,3686,266,0.0721649484536082,0.927835051546392
"42017100805",6002,6634,632,0.0952668073560446,0.904733192643955
"42017100806",8962,9654,692,0.0716801325875285,0.928319867412472
"42017100807",1916,2148,232,0.108007448789572,0.891992551210428
"42017100900",6184,6943,759,0.109318738297566,0.890681261702434
"42017101000",805,913,108,0.11829134720701,0.88170865279299
"42017101100",1905,2399,494,0.205919132972072,0.794080867027928
"42017101200",717,778,61,0.0784061696658098,0.92159383033419
"42017101300",1178,1362,184,0.135095447870778,0.864904552129222
"42017101401",3701,3998,297,0.0742871435717859,0.925712856428214
"42017101402",7810,9150,1340,0.146448087431694,0.853551912568306
"42017101403",6160,6559,399,0.0608324439701174,0.939167556029883
"42017101503",3693,4000,307,0.07675,0.92325
"42017101504",2491,2758,267,0.0968092820884699,0.90319071791153
"42017101505",3120,3275,155,0.0473282442748092,0.952671755725191
"42017101506",5162,5852,690,0.117908407382092,0.882091592617908
"42017101603",2849,3194,345,0.108015028177833,0.891984971822167
"42017101605",2557,4304,1747,0.405901486988848,0.594098513011152
"42017101607",2424,2621,197,0.0751621518504388,0.924837848149561
"42017101608",4105,4828,723,0.149751449875725,0.850248550124275
"42017101609",4873,5293,420,0.0793500850179482,0.920649914982052
"42017101610",5073,5340,267,0.05,0.95
"42017101611",6249,6850,601,0.0877372262773723,0.912262773722628
"42017101700",471,498,27,0.0542168674698795,0.94578313253012
"42017101802",1193,1297,104,0.0801850424055513,0.919814957594449
"42017101803",3460,3750,290,0.0773333333333333,0.922666666666667
"42017101804",6276,7058,782,0.110796259563616,0.889203740436384
"42017101900",2646,2956,310,0.104871447902571,0.895128552097429
"42017102002",2163,2350,187,0.0795744680851064,0.920425531914894
"42017102003",3187,3412,225,0.0659437280187573,0.934056271981243
"42017102004",3050,3294,244,0.0740740740740741,0.925925925925926
"42017102101",6470,7290,820,0.112482853223594,0.887517146776406
"42017102102",2867,3191,324,0.101535568787214,0.898464431212786
"42017102200",824,892,68,0.0762331838565022,0.923766816143498
"42017102300",3289,3732,443,0.118703108252947,0.881296891747053
"42017102400",6956,7825,869,0.111054313099042,0.888945686900958
"42017102500",3909,4458,549,0.123149394347241,0.876850605652759
"42017102600",1276,1616,340,0.21039603960396,0.78960396039604
"42017102700",3702,4283,581,0.135652579967313,0.864347420032687
"42017102801",2504,2722,218,0.0800881704628949,0.919911829537105
"42017102802",3912,4496,584,0.129893238434164,0.870106761565836
"42017102900",783,934,151,0.161670235546039,0.838329764453961
"42017103001",3466,3933,467,0.118738876175947,0.881261123824053
"42017103002",3838,4558,720,0.157964019306713,0.842035980693287
"42017103101",2072,2405,333,0.138461538461538,0.861538461538462
"42017103102",1568,1996,428,0.214428857715431,0.785571142284569
"42017103103",3140,4316,1176,0.272474513438369,0.727525486561631
"42017103200",778,1064,286,0.268796992481203,0.731203007518797
"42017103300",1819,2116,297,0.140359168241966,0.859640831758034
"42017103400",4249,4970,721,0.145070422535211,0.854929577464789
"42017103500",1052,1203,151,0.125519534497091,0.874480465502909
"42017103600",768,910,142,0.156043956043956,0.843956043956044
"42017103700",2909,3324,415,0.124849578820698,0.875150421179302
"42017103800",1135,1374,239,0.173944687045124,0.826055312954876
"42017103900",3342,4148,806,0.194310511089682,0.805689488910318
"42017104000",3825,4580,755,0.164847161572052,0.835152838427948
"42017104100",1599,1972,373,0.189148073022312,0.810851926977688
"42017104200",5665,6276,611,0.0973550031867431,0.902644996813257
"42017104300",5533,5965,432,0.0724224643755239,0.927577535624476
"42017104400",1207,1400,193,0.137857142857143,0.862142857142857
"42017104501",5592,6140,548,0.0892508143322476,0.910749185667752
"42017104502",2740,3078,338,0.109811565951917,0.890188434048083
"42017104601",4919,5011,92,0.0183596088605069,0.981640391139493
"42017104603",2275,2667,392,0.146981627296588,0.853018372703412
"42017104604",4272,4688,416,0.0887372013651877,0.911262798634812
"42017104701",2657,3220,563,0.174844720496894,0.825155279503106
"42017104702",2302,2773,471,0.169852145690588,0.830147854309412
"42017104703",2129,2232,103,0.0461469534050179,0.953853046594982
"42017104704",0,0,0,NA,NA
"42017104800",2042,2194,152,0.0692798541476755,0.930720145852325
"42017104901",2832,2916,84,0.0288065843621399,0.97119341563786
"42017104902",2705,2954,249,0.0842924847664184,0.915707515233582
"42017105003",4089,4324,235,0.0543478260869565,0.945652173913043
"42017105004",4952,5370,418,0.0778398510242086,0.922160148975791
"42017105005",9593,10143,550,0.0542245883860791,0.945775411613921
"42017105006",5279,5506,227,0.0412277515437704,0.95877224845623
"42017105007",7046,7373,327,0.0443510104435101,0.95564898955649
"42017105008",2256,2398,142,0.0592160133444537,0.940783986655546
"42017105100",2189,2386,197,0.0825649622799665,0.917435037720034
"42017105202",4702,4873,171,0.0350913195156988,0.964908680484301
"42017105203",1993,2014,21,0.0104270109235353,0.989572989076465
"42017105204",6305,6608,303,0.0458535108958838,0.954146489104116
"42017105300",2113,2565,452,0.176218323586745,0.823781676413255
"42017105400",5671,5997,326,0.0543605135901284,0.945639486409872
"42017105501",5150,5593,443,0.0792061505453245,0.920793849454675
"42017105503",5477,5707,230,0.0403013842649378,0.959698615735062
"42017105505",3736,3891,155,0.0398355178617322,0.960164482138268
"42017105506",3232,3299,67,0.0203091846013944,0.979690815398606
"42017105507",6266,6508,242,0.0371850030731408,0.962814996926859
"42017105600",2150,2324,174,0.0748709122203098,0.92512908777969
"42017105701",1036,1314,278,0.211567732115677,0.788432267884323
"42017105702",1619,2090,471,0.225358851674641,0.774641148325359
"42017105703",489,518,29,0.055984555984556,0.944015444015444
"42017105704",5164,6351,1187,0.186899700834514,0.813100299165486
"42017105801",5130,5644,514,0.091070163004961,0.908929836995039
"42017105802",10307,11901,1594,0.133938324510545,0.866061675489455
"42017105803",8963,10200,1237,0.121274509803922,0.878725490196078
"42017105805",5644,6486,842,0.12981806968856,0.87018193031144
"42017105806",38,72,34,0.472222222222222,0.527777777777778
"42017105901",1443,1656,213,0.128623188405797,0.871376811594203
"42017105902",363,569,206,0.362038664323374,0.637961335676626
"42017106000",0,0,0,NA,NA
"42017106100",0,0,0,NA,NA
"42029300101",2859,2962,103,0.0347738014854828,0.965226198514517
"42029300103",2096,2366,270,0.114116652578191,0.885883347421809
"42029300104",4961,5133,172,0.0335086693941165,0.966491330605884
"42029300106",4411,4561,150,0.0328875246656435,0.967112475334357
"42029300107",3263,3409,146,0.0428278087415664,0.957172191258434
"42029300198",8738,9514,776,0.0815640109312592,0.918435989068741
"42029300201",4218,4773,555,0.116279069767442,0.883720930232558
"42029300202",4373,4540,167,0.036784140969163,0.963215859030837
"42029300301",2616,2854,238,0.0833917309039944,0.916608269096006
"42029300302",3139,3339,200,0.0598981731057203,0.94010182689428
"42029300303",2665,3021,356,0.117841774246938,0.882158225753062
"42029300400",2532,2944,412,0.139945652173913,0.860054347826087
"42029300500",5049,5526,477,0.0863192182410423,0.913680781758958
"42029300600",2424,3194,770,0.241077019411396,0.758922980588604
"42029300700",3509,4724,1215,0.257197290431837,0.742802709568163
"42029300800",3823,4561,738,0.161806621354966,0.838193378645034
"42029300900",2088,2331,243,0.104247104247104,0.895752895752896
"42029301000",5446,5811,365,0.0628119084494923,0.937188091550508
"42029301100",2844,3409,565,0.165737753006747,0.834262246993253
"42029301201",0,0,0,NA,NA
"42029301202",3249,4066,817,0.200934579439252,0.799065420560748
"42029301300",3867,4266,399,0.0935302390998594,0.906469760900141
"42029301401",2703,3132,429,0.136973180076628,0.863026819923372
"42029301402",3906,4342,436,0.100414555504376,0.899585444495624
"42029301500",1428,1627,199,0.122311001843884,0.877688998156116
"42029301600",2214,2571,357,0.138856476079347,0.861143523920653
"42029301700",1187,1336,149,0.111526946107784,0.888473053892216
"42029301800",1867,2272,405,0.178257042253521,0.821742957746479
"42029301900",2180,2281,101,0.0442788250767207,0.955721174923279
"42029302000",2208,2373,165,0.0695322376738306,0.930467762326169
"42029302101",4095,4623,528,0.114211550940947,0.885788449059053
"42029302102",2661,3044,383,0.125821287779238,0.874178712220762
"42029302201",7904,8304,400,0.0481695568400771,0.951830443159923
"42029302202",3573,3846,273,0.0709828393135725,0.929017160686427
"42029302300",2137,2366,229,0.0967878275570583,0.903212172442942
"42029302400",2807,4084,1277,0.312683643486778,0.687316356513222
"42029302500",2852,3830,978,0.255352480417755,0.744647519582246
"42029302600",2171,4399,2228,0.506478745169357,0.493521254830643
"42029302701",6934,7543,609,0.0807371072517566,0.919262892748243
"42029302702",4284,4711,427,0.0906389301634472,0.909361069836553
"42029302703",2683,2882,199,0.0690492713393477,0.930950728660652
"42029302704",2521,2636,115,0.0436267071320182,0.956373292867982
"42029302801",9229,9636,407,0.0422374429223744,0.957762557077626
"42029302802",3508,3671,163,0.0444020702805775,0.955597929719422
"42029302803",1747,1818,71,0.0390539053905391,0.960946094609461
"42029302901",4136,4357,221,0.0507229745237549,0.949277025476245
"42029302902",5107,5305,198,0.0373232799245994,0.962676720075401
"42029303098",1031,1118,87,0.0778175313059034,0.922182468694097
"42029303100",2521,2630,109,0.0414448669201521,0.958555133079848
"42029303200",2691,2842,151,0.0531315974665728,0.946868402533427
"42029303300",4128,4585,457,0.0996728462377317,0.900327153762268
"42029303401",2729,3420,691,0.202046783625731,0.797953216374269
"42029303402",1236,1647,411,0.249544626593807,0.750455373406193
"42029303500",4489,4778,289,0.0604855588112181,0.939514441188782
"42029303600",2250,2376,126,0.053030303030303,0.946969696969697
"42029303700",958,1084,126,0.116236162361624,0.883763837638376
"42029303801",3386,3617,231,0.0638650815593033,0.936134918440697
"42029303802",6205,6488,283,0.0436189889025894,0.956381011097411
"42029303900",5793,6201,408,0.065795839380745,0.934204160619255
"42029304000",2185,2499,314,0.125650260104042,0.874349739895958
"42029304101",3842,4281,439,0.102546134080822,0.897453865919178
"42029304102",2832,3307,475,0.143634714242516,0.856365285757484
"42029304201",5234,5957,723,0.121369817021991,0.878630182978009
"42029304202",4135,4907,772,0.157326268595883,0.842673731404117
"42029304300",4952,5311,359,0.0675955563923931,0.932404443607607
"42029304401",8039,8419,380,0.0451360019004632,0.954863998099537
"42029304402",4375,4580,205,0.0447598253275109,0.955240174672489
"42029304500",4152,4390,238,0.0542141230068337,0.945785876993166
"42029304600",1987,2316,329,0.142055267702936,0.857944732297064
"42029304700",1534,1950,416,0.213333333333333,0.786666666666667
"42029304800",405,468,63,0.134615384615385,0.865384615384615
"42029304900",3860,5119,1259,0.245946473920688,0.754053526079312
"42029305000",979,1181,202,0.171041490262489,0.828958509737511
"42029305100",5254,6143,889,0.144717564707797,0.855282435292202
"42029305200",5163,5802,639,0.110134436401241,0.889865563598759
"42029305300",3196,3877,681,0.175651276760382,0.824348723239618
"42029305400",1362,2202,840,0.381471389645777,0.618528610354223
"42029305500",1766,3315,1549,0.467269984917044,0.532730015082956
"42029305600",1522,3022,1500,0.496360026472535,0.503639973527465
"42029305700",1959,2488,529,0.212620578778135,0.787379421221865
"42029305800",636,1070,434,0.405607476635514,0.594392523364486
"42029305900",249,511,262,0.512720156555773,0.487279843444227
"42029306000",3799,4422,623,0.140886476707372,0.859113523292628
"42029306100",690,876,186,0.212328767123288,0.787671232876712
"42029306200",3156,3788,632,0.166842661034847,0.833157338965153
"42029306300",1657,2122,465,0.219132893496701,0.780867106503299
"42029306400",703,950,247,0.26,0.74
"42029306500",3681,5386,1705,0.316561455625696,0.683438544374304
"42029306600",2495,2664,169,0.0634384384384384,0.936561561561562
"42029306700",2526,2779,253,0.0910399424253329,0.908960057574667
"42029306800",908,1129,221,0.195748449955713,0.804251550044287
"42029306900",2389,2710,321,0.118450184501845,0.881549815498155
"42029307000",1809,2254,445,0.197426796805679,0.802573203194321
"42029307100",1023,1241,218,0.17566478646253,0.82433521353747
"42029307200",981,1198,217,0.181135225375626,0.818864774624374
"42029307300",2155,2511,356,0.141776184786937,0.858223815213063
"42029307400",2362,2957,595,0.201217450118363,0.798782549881637
"42029307500",1803,2162,359,0.166049953746531,0.833950046253469
"42029307600",637,813,176,0.216482164821648,0.783517835178352
"42029307700",2051,2336,285,0.122003424657534,0.877996575342466
"42029307800",1295,1632,337,0.206495098039216,0.793504901960784
"42029307900",1792,2261,469,0.207430340557276,0.792569659442725
"42029308000",2206,3623,1417,0.391112337841568,0.608887662158432
"42029308100",3094,3817,723,0.189415771548336,0.810584228451664
"42029308200",1543,2175,632,0.290574712643678,0.709425287356322
"42029310200",149,243,94,0.386831275720165,0.613168724279835
"42029310300",0,0,0,NA,NA
"42029310497",68,85,17,0.2,0.8
"42029310498",34,55,21,0.381818181818182,0.618181818181818
"42029310500",240,283,43,0.151943462897526,0.848056537102474
"42029310600",0,0,0,NA,NA
"42029310700",0,0,0,NA,NA
"42029310800",0,0,0,NA,NA
"42045400100",448,818,370,0.452322738386308,0.547677261613692
"42045400200",2386,3323,937,0.281974119771291,0.718025880228709
"42045400301",3934,5966,2032,0.340596714716728,0.659403285283272
"42045400302",2611,3797,1186,0.312351856728997,0.687648143271003
"42045400401",2834,3992,1158,0.290080160320641,0.709919839679359
"42045400402",2840,3861,1021,0.264439264439264,0.735560735560736
"42045400500",3192,4244,1052,0.247879359095193,0.752120640904807
"42045400600",4325,5331,1006,0.188707559557306,0.811292440442694
"42045400700",3846,4822,976,0.202405640812941,0.797594359187059
"42045400801",1561,1984,423,0.21320564516129,0.78679435483871
"42045400802",3151,3523,372,0.105591825149021,0.894408174850979
"42045400900",1721,1836,115,0.062636165577342,0.937363834422658
"42045401000",1837,2046,209,0.102150537634409,0.897849462365591
"42045401101",2811,3267,456,0.139577594123049,0.860422405876951
"42045401102",6951,7777,826,0.106210621062106,0.893789378937894
"42045401200",3375,3863,488,0.126326689101734,0.873673310898266
"42045401301",1682,2096,414,0.197519083969466,0.802480916030534
"42045401302",2739,3110,371,0.119292604501608,0.880707395498392
"42045401401",1987,2198,211,0.0959963603275705,0.904003639672429
"42045401402",3394,4051,657,0.162182177240188,0.837817822759812
"42045401501",3454,3874,420,0.108415074858028,0.891584925141972
"42045401502",2570,3021,451,0.149288315127441,0.850711684872559
"42045401503",858,1025,167,0.162926829268293,0.837073170731707
"42045401600",1688,1863,175,0.0939345142243693,0.906065485775631
"42045401700",2060,2637,577,0.218809252938946,0.781190747061054
"42045401800",3366,3918,552,0.140888208269525,0.859111791730475
"42045401900",4539,5079,540,0.106320141760189,0.893679858239811
"42045402000",2127,2704,577,0.213387573964497,0.786612426035503
"42045402100",5331,6174,843,0.136540330417881,0.863459669582119
"42045402200",1748,2172,424,0.195211786372007,0.804788213627993
"42045402300",2836,3322,486,0.146297411198073,0.853702588801927
"42045402400",2262,3858,1596,0.413685847589425,0.586314152410575
"42045402500",1957,3526,1569,0.444980147475893,0.555019852524107
"42045402600",2627,3388,761,0.224616292798111,0.775383707201889
"42045402700",1867,2613,746,0.285495598928435,0.714504401071565
"42045402800",4305,5740,1435,0.25,0.75
"42045402900",2006,3954,1948,0.492665655032878,0.507334344967122
"42045403001",2911,3591,680,0.189362294625453,0.810637705374547
"42045403002",2696,3375,679,0.201185185185185,0.798814814814815
"42045403101",2688,3633,945,0.260115606936416,0.739884393063584
"42045403103",2493,2992,499,0.16677807486631,0.83322192513369
"42045403104",1874,2505,631,0.25189620758483,0.74810379241517
"42045403200",3990,4540,550,0.121145374449339,0.878854625550661
"42045403300",5603,7105,1502,0.211400422237861,0.788599577762139
"42045403401",2635,3207,572,0.178359837854693,0.821640162145307
"42045403402",3727,4267,540,0.126552613077103,0.873447386922897
"42045403501",3683,4408,725,0.164473684210526,0.835526315789474
"42045403502",2347,2830,483,0.170671378091873,0.829328621908127
"42045403601",3477,3986,509,0.127696939287506,0.872303060712494
"42045403602",1858,2140,282,0.131775700934579,0.868224299065421
"42045403701",1427,1768,341,0.192873303167421,0.807126696832579
"42045403702",2054,2638,584,0.221379833206975,0.778620166793025
"42045403800",5185,6584,1399,0.212484811664642,0.787515188335358
"42045403901",2849,3504,655,0.186929223744292,0.813070776255708
"42045403902",3653,3916,263,0.0671603677221655,0.932839632277835
"42045404002",6429,7550,1121,0.148476821192053,0.851523178807947
"42045404003",1576,1913,337,0.176163094615787,0.823836905384213
"42045404004",5743,6440,697,0.108229813664596,0.891770186335404
"42045404101",5115,6531,1416,0.216812126779972,0.783187873220028
"42045404102",3994,5197,1203,0.231479699826823,0.768520300173177
"42045404103",3104,3524,420,0.119182746878547,0.880817253121453
"42045404200",720,828,108,0.130434782608696,0.869565217391304
"42045404300",1874,2427,553,0.227853316852081,0.772146683147919
"42045404400",1170,1563,393,0.251439539347409,0.748560460652591
"42045404500",3108,4595,1487,0.323612622415669,0.676387377584331
"42045404600",1514,2232,718,0.32168458781362,0.67831541218638
"42045404700",1443,2697,1254,0.46496106785317,0.53503893214683
"42045404800",1240,2744,1504,0.548104956268222,0.451895043731778
"42045404901",1112,2192,1080,0.492700729927007,0.507299270072993
"42045404902",155,939,784,0.83493077742279,0.16506922257721
"42045405000",1162,1957,795,0.406234031681145,0.593765968318855
"42045405100",1377,2554,1177,0.460845732184808,0.539154267815192
"42045405200",1495,4513,3018,0.668734766230889,0.331265233769111
"42045405300",2206,4000,1794,0.4485,0.5515
"42045405400",1724,3344,1620,0.48444976076555,0.51555023923445
"42045405500",275,871,596,0.684270952927669,0.315729047072331
"42045405600",159,526,367,0.697718631178707,0.302281368821293
"42045405700",754,1719,965,0.561372891215823,0.438627108784177
"42045405801",512,1277,765,0.599060297572435,0.400939702427565
"42045405802",493,1601,1108,0.692067457838851,0.307932542161149
"42045405900",124,486,362,0.744855967078189,0.255144032921811
"42045406000",104,195,91,0.466666666666667,0.533333333333333
"42045406100",2111,2585,474,0.183365570599613,0.816634429400387
"42045406201",2856,3437,581,0.169042769857434,0.830957230142566
"42045406202",4850,5123,273,0.0532890884247511,0.946710911575249
"42045406300",2269,3285,1016,0.309284627092846,0.690715372907154
"42045406401",2598,3230,632,0.195665634674923,0.804334365325077
"42045406402",804,2023,1219,0.602570439940682,0.397429560059318
"42045406500",1524,2256,732,0.324468085106383,0.675531914893617
"42045406600",1523,2450,927,0.378367346938775,0.621632653061225
"42045406700",2584,3630,1046,0.288154269972452,0.711845730027548
"42045406800",38,38,0,0,1
"42045406801",3259,3720,461,0.123924731182796,0.876075268817204
"42045406802",4032,4976,944,0.189710610932476,0.810289389067524
"42045406803",5622,6258,636,0.101629913710451,0.898370086289549
"42045406902",5360,5876,516,0.0878148400272294,0.912185159972771
"42045406903",5355,5785,430,0.0743301642178047,0.925669835782195
"42045406904",2859,3252,393,0.120848708487085,0.879151291512915
"42045407000",2120,2254,134,0.059449866903283,0.940550133096717
"42045407101",2799,3083,284,0.0921180668180344,0.907881933181966
"42045407102",2875,3072,197,0.0641276041666667,0.935872395833333
"42045407201",2545,2748,203,0.0738719068413392,0.926128093158661
"42045407202",2141,2290,149,0.0650655021834061,0.934934497816594
"42045407300",939,982,43,0.0437881873727088,0.956211812627291
"42045407401",2186,2405,219,0.0910602910602911,0.908939708939709
"42045407402",1186,1351,165,0.122131754256107,0.877868245743893
"42045407403",5775,6545,770,0.117647058823529,0.882352941176471
"42045407404",2562,2719,157,0.0577418168444281,0.942258183155572
"42045407501",1972,2495,523,0.209619238476954,0.790380761523046
"42045407502",2347,3000,653,0.217666666666667,0.782333333333333
"42045407600",4555,4905,350,0.0713557594291539,0.928644240570846
"42045407700",2352,2834,482,0.170077628793225,0.829922371206775
"42045407801",3794,3944,150,0.0380324543610548,0.961967545638945
"42045407802",6178,6572,394,0.0599513085818624,0.940048691418138
"42045407803",4993,5452,459,0.0841892883345561,0.915810711665444
"42045407804",4247,4577,330,0.072099628577671,0.927900371422329
"42045407805",3175,3443,268,0.0778390938135347,0.922160906186465
"42045407901",3767,3913,146,0.0373115256836187,0.962688474316381
"42045407902",2388,2668,280,0.104947526236882,0.895052473763118
"42045407903",2609,3067,458,0.149331594391914,0.850668405608086
"42045408001",5513,6014,501,0.0833056202194879,0.916694379780512
"42045408002",3396,3745,349,0.0931909212283044,0.906809078771696
"42045408101",4395,4766,371,0.0778430549727235,0.922156945027277
"42045408102",2996,3350,354,0.105671641791045,0.894328358208955
"42045408103",3776,4345,569,0.130955120828539,0.869044879171461
"42045408200",954,1257,303,0.241050119331742,0.758949880668258
"42045408300",2255,2840,585,0.205985915492958,0.794014084507042
"42045408400",1503,1533,30,0.0195694716242661,0.980430528375734
"42045408500",3348,4010,662,0.165087281795511,0.834912718204489
"42045408600",3365,3624,259,0.0714679911699779,0.928532008830022
"42045408700",4710,4920,210,0.0426829268292683,0.957317073170732
"42045408800",4649,5153,504,0.0978071026586455,0.902192897341355
"42045408900",2809,3142,333,0.105983450031827,0.894016549968173
"42045409000",3606,3886,280,0.0720535254760679,0.927946474523932
"42045409100",3977,4368,391,0.089514652014652,0.910485347985348
"42045409200",3879,4196,317,0.0755481410867493,0.924451858913251
"42045409300",1931,2374,443,0.186604886267902,0.813395113732098
"42045409400",2539,2676,137,0.0511958146487294,0.948804185351271
"42045409500",4483,4649,166,0.0357066035706604,0.96429339642934
"42045409601",4136,4591,455,0.0991069483772599,0.90089305162274
"42045409602",2927,3565,638,0.178962131837307,0.821037868162693
"42045409701",5130,5510,380,0.0689655172413793,0.931034482758621
"42045409702",40,40,0,0,1
"42045409802",3344,3600,256,0.0711111111111111,0.928888888888889
"42045409898",5699,6650,951,0.143007518796992,0.856992481203008
"42045409902",3471,3825,354,0.0925490196078431,0.907450980392157
"42045409903",3792,4165,373,0.0895558223289316,0.910444177671068
"42045409904",2943,3317,374,0.112752487187217,0.887247512812783
"42045410000",2480,2761,281,0.1017747193046,0.8982252806954
"42045410101",0,0,0,NA,NA
"42045410102",2606,2789,183,0.0656149157404087,0.934385084259591
"42045410200",2970,3118,148,0.0474663245670301,0.95253367543297
"42045410301",4035,4295,260,0.0605355064027939,0.939464493597206
"42045410302",2234,2491,257,0.103171417101566,0.896828582898434
"42045410400",2921,3290,369,0.112158054711246,0.887841945288754
"42091200103",3474,3622,148,0.0408614025400331,0.959138597459967
"42091200104",3925,4224,299,0.0707859848484848,0.929214015151515
"42091200105",2147,2299,152,0.0661157024793388,0.933884297520661
"42091200106",1413,1617,204,0.126159554730983,0.873840445269017
"42091200200",893,996,103,0.103413654618474,0.896586345381526
"42091200301",5185,6052,867,0.143258426966292,0.856741573033708
"42091200305",1727,1943,216,0.111168296448791,0.888831703551209
"42091200306",3932,4426,494,0.111613194758247,0.888386805241753
"42091200307",2579,3022,443,0.146591661151555,0.853408338848445
"42091200308",3467,4066,599,0.147319232661092,0.852680767338908
"42091200309",2436,2667,231,0.0866141732283465,0.913385826771654
"42091200310",2723,2800,77,0.0275,0.9725
"42091200401",3051,3601,550,0.152735351291308,0.847264648708692
"42091200402",3279,3750,471,0.1256,0.8744
"42091200501",3327,3608,281,0.0778824833702882,0.922117516629712
"42091200502",5107,5965,858,0.143839061190277,0.856160938809723
"42091200504",45,45,0,0,1
"42091200505",2598,2865,267,0.0931937172774869,0.906806282722513
"42091200506",3463,3730,267,0.0715817694369973,0.928418230563003
"42091200507",5046,5252,206,0.0392231530845392,0.960776846915461
"42091200601",8093,8501,408,0.0479943536054582,0.952005646394542
"42091200602",3330,3586,256,0.0713887339654211,0.928611266034579
"42091200703",3925,4315,390,0.0903823870220162,0.909617612977984
"42091200704",2800,3084,284,0.0920881971465629,0.907911802853437
"42091200706",6619,7787,1168,0.149993579041993,0.850006420958007
"42091200800",2219,2590,371,0.143243243243243,0.856756756756757
"42091200901",3345,3806,461,0.121124540199685,0.878875459800315
"42091200902",1109,1287,178,0.138306138306138,0.861693861693862
"42091200903",3463,4129,666,0.161298135141681,0.838701864858319
"42091200905",723,899,176,0.195773081201335,0.804226918798665
"42091200906",1684,2026,342,0.168805528134255,0.831194471865745
"42091200907",2374,2772,398,0.143578643578644,0.856421356421356
"42091200908",1032,1158,126,0.10880829015544,0.89119170984456
"42091201002",5858,6051,193,0.0318955544538093,0.968104445546191
"42091201003",3051,3348,297,0.0887096774193548,0.911290322580645
"42091201004",2489,2562,73,0.0284933645589383,0.971506635441062
"42091201100",3203,3787,584,0.154211777132295,0.845788222867705
"42091201201",4435,4581,146,0.0318707705741105,0.96812922942589
"42091201203",2018,2203,185,0.0839763958238765,0.916023604176123
"42091201204",2064,2265,201,0.0887417218543046,0.911258278145695
"42091201301",2816,3244,428,0.13193588162762,0.86806411837238
"42091201302",2450,3169,719,0.226885452824235,0.773114547175765
"42091201404",4364,4671,307,0.065724684221794,0.934275315778206
"42091201406",4290,4461,171,0.0383322125084062,0.961667787491594
"42091201407",2105,2618,513,0.195951107715814,0.804048892284186
"42091201408",3247,3408,161,0.0472417840375587,0.952758215962441
"42091201409",3315,3486,171,0.0490533562822719,0.950946643717728
"42091201410",2124,2381,257,0.107937841243175,0.892062158756825
"42091201411",2319,2573,254,0.0987174504469491,0.901282549553051
"42091201501",2746,3052,306,0.100262123197903,0.899737876802097
"42091201502",1666,1756,90,0.05125284738041,0.94874715261959
"42091201603",4274,5233,959,0.183260080259889,0.816739919740111
"42091201604",3189,3552,363,0.102195945945946,0.897804054054054
"42091201605",2717,3105,388,0.124959742351047,0.875040257648953
"42091201606",1461,2014,553,0.274577954319762,0.725422045680238
"42091201607",3076,3410,334,0.0979472140762463,0.902052785923754
"42091201608",4304,4629,325,0.0702095484985958,0.929790451501404
"42091201703",2781,3061,280,0.0914733747141457,0.908526625285854
"42091201704",3238,3489,251,0.0719403840642018,0.928059615935798
"42091201705",4203,4730,527,0.111416490486258,0.888583509513742
"42091201706",3890,4311,421,0.0976571561122709,0.902342843887729
"42091201800",2737,3020,283,0.0937086092715232,0.906291390728477
"42091201901",4250,4673,423,0.0905200085598117,0.909479991440188
"42091201902",4722,5587,865,0.154823697870055,0.845176302129945
"42091202000",2374,2679,305,0.11384845091452,0.88615154908548
"42091202100",4127,4574,447,0.0977262789680804,0.90227372103192
"42091202201",4240,4636,396,0.0854184641932701,0.91458153580673
"42091202298",2605,2831,226,0.0798304486047333,0.920169551395267
"42091202301",3679,3984,305,0.0765562248995984,0.923443775100402
"42091202302",2182,2342,160,0.0683176771989752,0.931682322801025
"42091202401",2462,3239,777,0.239888854584748,0.760111145415252
"42091202402",4002,4726,724,0.153195090986035,0.846804909013965
"42091202500",4015,4348,333,0.0765869365225391,0.923413063477461
"42091202602",2049,2289,240,0.104849279161206,0.895150720838794
"42091202603",2950,3297,347,0.105247194419169,0.894752805580831
"42091202604",2024,2233,209,0.0935960591133005,0.9064039408867
"42091203000",1946,2129,183,0.085955847815876,0.914044152184124
"42091203103",2844,3012,168,0.0557768924302789,0.944223107569721
"42091203104",3515,3783,268,0.0708432461009781,0.929156753899022
"42091203105",3817,4003,186,0.0464651511366475,0.953534848863352
"42091203106",1425,1670,245,0.146706586826347,0.853293413173653
"42091203203",3630,3950,320,0.0810126582278481,0.918987341772152
"42091203204",2385,2623,238,0.0907357987037743,0.909264201296226
"42091203205",2383,2501,118,0.0471811275489804,0.95281887245102
"42091203206",5897,6040,143,0.0236754966887417,0.976324503311258
"42091203302",5592,5949,357,0.0600100857286939,0.939989914271306
"42091203303",3048,3344,296,0.0885167464114833,0.911483253588517
"42091203304",2885,3147,262,0.0832538925961233,0.916746107403877
"42091203401",5868,6550,682,0.10412213740458,0.89587786259542
"42091203402",5014,5401,387,0.071653397518978,0.928346602481022
"42091203403",2803,3019,216,0.0715468698244452,0.928453130175555
"42091203500",5262,6331,1069,0.168851682198705,0.831148317801295
"42091203601",1543,2763,1220,0.441549040897575,0.558450959102425
"42091203602",3665,4378,713,0.162859753312015,0.837140246687985
"42091203700",83,170,87,0.511764705882353,0.488235294117647
"42091203801",2532,3188,656,0.205771643663739,0.794228356336261
"42091203803",3285,4404,1119,0.25408719346049,0.74591280653951
"42091203804",2196,3007,811,0.26970402394413,0.73029597605587
"42091203901",1600,3159,1559,0.493510604621716,0.506489395378284
"42091203902",1263,2438,1175,0.481952420016407,0.518047579983593
"42091204002",2807,3083,276,0.0895231916963996,0.9104768083036
"42091204004",2293,2411,118,0.0489423475736209,0.951057652426379
"42091204005",1265,1452,187,0.128787878787879,0.871212121212121
"42091204007",2105,2403,298,0.12401165210154,0.87598834789846
"42091204008",1947,2250,303,0.134666666666667,0.865333333333333
"42091204009",1348,1403,55,0.0392017106200998,0.9607982893799
"42091204010",2588,2721,133,0.0488790885703785,0.951120911429622
"42091204101",4028,4896,868,0.177287581699346,0.822712418300654
"42091204102",1851,3155,1304,0.413312202852615,0.586687797147385
"42091204200",956,1255,299,0.238247011952191,0.761752988047809
"42091204300",2293,2414,121,0.0501242750621375,0.949875724937862
"42091204400",2941,3276,335,0.102258852258852,0.897741147741148
"42091204500",4271,4564,293,0.0641980718667835,0.935801928133216
"42091204600",4373,4631,258,0.0557115093932196,0.94428849060678
"42091204701",2058,2174,116,0.0533578656853726,0.946642134314627
"42091204702",3194,3543,349,0.0985040925769122,0.901495907423088
"42091204800",4908,5131,223,0.0434613135840967,0.956538686415903
"42091204900",4091,4396,305,0.0693812556869882,0.930618744313012
"42091205000",1397,1677,280,0.166964818127609,0.833035181872391
"42091205100",1338,1779,441,0.247892074198988,0.752107925801012
"42091205200",2538,2681,143,0.0533383066020142,0.946661693397986
"42091205300",1355,1779,424,0.238336143901068,0.761663856098932
"42091205400",5661,6135,474,0.0772616136919315,0.922738386308068
"42091205501",2941,3616,675,0.186670353982301,0.813329646017699
"42091205502",5503,5854,351,0.0599590023915272,0.940040997608473
"42091205503",2005,2209,204,0.0923494794024445,0.907650520597555
"42091205600",3758,4278,520,0.121552127162225,0.878447872837775
"42091205700",3068,4276,1208,0.282507015902713,0.717492984097287
"42091205805",3425,3749,324,0.0864230461456388,0.913576953854361
"42091205806",1445,1694,249,0.146989374262102,0.853010625737898
"42091205807",1512,1742,230,0.13203214695752,0.86796785304248
"42091205808",4300,4461,161,0.0360905626541134,0.963909437345887
"42091205809",2418,2668,250,0.0937031484257871,0.906296851574213
"42091205898",2231,2407,176,0.0731200664727877,0.926879933527212
"42091205904",1659,1813,154,0.0849420849420849,0.915057915057915
"42091205905",2833,3175,342,0.107716535433071,0.892283464566929
"42091205906",1613,1754,141,0.080387685290764,0.919612314709236
"42091205998",2192,2230,38,0.0170403587443946,0.982959641255605
"42091206004",3504,3812,308,0.080797481636936,0.919202518363064
"42091206005",3539,3989,450,0.11281022812735,0.88718977187265
"42091206006",1886,2054,168,0.0817916260954236,0.918208373904576
"42091206007",4423,4719,296,0.0627251536342445,0.937274846365755
"42091206008",2527,2909,382,0.131316603643864,0.868683396356136
"42091206009",460,567,107,0.188712522045855,0.811287477954145
"42091206102",2805,3141,336,0.106972301814709,0.893027698185291
"42091206104",963,1094,131,0.119744058500914,0.880255941499086
"42091206105",1283,1339,56,0.0418222554144884,0.958177744585512
"42091206106",3285,3465,180,0.051948051948052,0.948051948051948
"42091206201",2262,2654,392,0.147701582516956,0.852298417483044
"42091206202",1542,1804,262,0.145232815964523,0.854767184035477
"42091206300",3071,3306,235,0.0710828796128252,0.928917120387175
"42091206400",1874,2112,238,0.112689393939394,0.887310606060606
"42091206500",2801,3197,396,0.123866124491711,0.876133875508289
"42091206600",1021,1250,229,0.1832,0.8168
"42091206701",4224,4547,323,0.071035847811744,0.928964152188256
"42091206702",0,0,0,NA,NA
"42091206800",4605,5183,578,0.111518425622227,0.888481574377774
"42091206901",3457,3899,442,0.113362400615542,0.886637599384458
"42091206904",3523,3926,403,0.102649006622517,0.897350993377483
"42091206905",2602,2745,143,0.0520947176684882,0.947905282331512
"42091206906",3392,3488,96,0.0275229357798165,0.972477064220183
"42091207001",4465,4941,476,0.0963367739324024,0.903663226067598
"42091207002",5031,5708,677,0.118605466012614,0.881394533987386
"42091207101",2936,3266,330,0.101041028781384,0.898958971218616
"42091207102",3364,3638,274,0.0753161077515118,0.924683892248488
"42091207201",1733,2057,324,0.157510938259601,0.842489061740399
"42091207202",3172,3869,697,0.180149909537348,0.819850090462652
"42091207300",2288,2565,277,0.107992202729045,0.892007797270955
"42091207400",1995,2216,221,0.0997292418772563,0.900270758122744
"42091207500",2449,2704,255,0.0943047337278106,0.905695266272189
"42091207698",2733,3057,324,0.105986261040236,0.894013738959764
"42091207700",371,440,69,0.156818181818182,0.843181818181818
"42091207800",4288,4590,302,0.0657952069716776,0.934204793028322
"42091207900",1480,1775,295,0.166197183098592,0.833802816901408
"42091208000",1842,2341,499,0.21315677061085,0.78684322938915
"42091208100",2483,3110,627,0.201607717041801,0.798392282958199
"42091208201",1518,1661,143,0.0860927152317881,0.913907284768212
"42091208202",4813,5300,487,0.0918867924528302,0.90811320754717
"42091208300",5552,5983,431,0.0720374394116664,0.927962560588334
"42091208400",1829,2011,182,0.0905022376926902,0.90949776230731
"42091208500",2815,3381,566,0.167406092871931,0.832593907128069
"42091208601",2318,2855,537,0.188091068301226,0.811908931698774
"42091208602",3295,3862,567,0.146815121698602,0.853184878301398
"42091208701",4523,5649,1126,0.19932731456895,0.80067268543105
"42091208702",2866,3116,250,0.0802310654685494,0.919768934531451
"42091208801",642,1061,419,0.394910461828464,0.605089538171536
"42091208802",5328,7667,2339,0.305073692448154,0.694926307551846
"42091208901",2426,2904,478,0.164600550964187,0.835399449035813
"42091208903",1939,2353,414,0.175945601359966,0.824054398640034
"42091208904",53,61,8,0.131147540983607,0.868852459016393
"42091208905",2245,2670,425,0.159176029962547,0.840823970037453
"42091208906",2503,3097,594,0.191798514691637,0.808201485308363
"42091209000",822,1235,413,0.334412955465587,0.665587044534413
"42091209100",2912,3223,311,0.0964939497362706,0.903506050263729
"42091209202",1016,1209,193,0.159636062861869,0.840363937138131
"42091209298",2373,3156,783,0.248098859315589,0.751901140684411
"42091210100",3400,4032,632,0.156746031746032,0.843253968253968
"42091210200",2648,2905,257,0.0884681583476764,0.911531841652324
"42091210300",2915,3603,688,0.190951984457397,0.809048015542603
"42091210400",3750,4041,291,0.0720118782479584,0.927988121752042
"42091210500",3725,3931,206,0.0524039684558636,0.947596031544136
"42101000100",1578,2067,489,0.236574746008708,0.763425253991292
"42101000200",405,1281,876,0.68384074941452,0.31615925058548
"42101000300",1664,2235,571,0.255480984340045,0.744519015659955
"42101000400",2071,2981,910,0.305266689030527,0.694733310969473
"42101000500",629,1120,491,0.438392857142857,0.561607142857143
"42101000600",146,380,234,0.615789473684211,0.384210526315789
"42101000700",2223,3010,787,0.261461794019934,0.738538205980066
"42101000800",6446,7696,1250,0.162422037422037,0.837577962577963
"42101000900",2234,4178,1944,0.465294399234083,0.534705600765917
"42101001000",5276,5761,485,0.084186773129665,0.915813226870335
"42101001100",4046,5587,1541,0.275818865222839,0.724181134777161
"42101001200",6131,7995,1864,0.233145716072545,0.766854283927455
"42101001300",1803,4522,2719,0.601282618310482,0.398717381689518
"42101001400",1289,3750,2461,0.656266666666667,0.343733333333333
"42101001500",1351,2504,1153,0.460463258785943,0.539536741214057
"42101001600",1522,1976,454,0.229757085020243,0.770242914979757
"42101001700",1875,2492,617,0.247592295345104,0.752407704654896
"42101001800",1369,3239,1870,0.577338684779253,0.422661315220747
"42101001900",643,2362,1719,0.727773073666384,0.272226926333616
"42101002000",748,2515,1767,0.70258449304175,0.29741550695825
"42101002100",1048,2546,1498,0.588373919874313,0.411626080125687
"42101002200",734,2245,1511,0.673051224944321,0.326948775055679
"42101002300",1242,2450,1208,0.493061224489796,0.506938775510204
"42101002400",2011,4390,2379,0.541913439635535,0.458086560364465
"42101002500",1634,3435,1801,0.524308588064047,0.475691411935953
"42101002600",0,0,0,NA,NA
"42101002700",4193,7326,3133,0.427654927654928,0.572345072345072
"42101002800",4909,8950,4041,0.451508379888268,0.548491620111732
"42101002900",2884,4017,1133,0.282051282051282,0.717948717948718
"42101003000",3893,8336,4443,0.532989443378119,0.467010556621881
"42101003100",2540,5956,3416,0.573539288112827,0.426460711887173
"42101003200",2520,5976,3456,0.578313253012048,0.421686746987952
"42101003300",2975,6010,3035,0.504991680532446,0.495008319467554
"42101003400",180,587,407,0.69335604770017,0.30664395229983
"42101003500",53,84,31,0.369047619047619,0.630952380952381
"42101003600",2286,7401,5115,0.691122821240373,0.308877178759627
"42101003700",6518,10350,3832,0.37024154589372,0.62975845410628
"42101003898",3187,4092,905,0.221163245356794,0.778836754643206
"42101003900",8351,11753,3402,0.289458010720667,0.710541989279333
"42101004000",6786,9437,2651,0.280915545194447,0.719084454805553
"42101004100",5617,13281,7664,0.577064980046683,0.422935019953317
"42101004200",7119,10940,3821,0.34926873857404,0.65073126142596
"42101004300",47,47,0,0,1
"42101004400",703,1109,406,0.36609558160505,0.63390441839495
"42101004500",2366,3213,847,0.263616557734205,0.736383442265795
"42101004600",147,2486,2339,0.940868865647627,0.0591311343523733
"42101004798",2824,4063,1239,0.304947083435885,0.695052916564115
"42101004800",448,500,52,0.104,0.896
"42101004900",0,0,0,NA,NA
"42101005000",1097,1584,487,0.307449494949495,0.692550505050505
"42101005100",590,1198,608,0.507512520868113,0.492487479131887
"42101005200",15,39,24,0.615384615384615,0.384615384615385
"42101005400",1030,1365,335,0.245421245421245,0.754578754578755
"42101005500",5167,6082,915,0.150443932916804,0.849556067083196
"42101005600",490,1287,797,0.619269619269619,0.380730380730381
"42101005700",0,0,0,NA,NA
"42101005800",16,33,17,0.515151515151515,0.484848484848485
"42101005900",0,0,0,NA,NA
"42101006000",4745,6541,1796,0.274575752942975,0.725424247057025
"42101006100",2401,3146,745,0.236808645899555,0.763191354100445
"42101006200",2670,4032,1362,0.337797619047619,0.662202380952381
"42101006300",1851,4491,2640,0.587842351369405,0.412157648630595
"42101006400",2538,4228,1690,0.399716177861873,0.600283822138127
"42101006500",3469,6265,2796,0.446288906624102,0.553711093375898
"42101006600",1560,4050,2490,0.614814814814815,0.385185185185185
"42101006700",4198,6398,2200,0.34385745545483,0.65614254454517
"42101006800",0,0,0,NA,NA
"42101006900",589,2442,1853,0.758804258804259,0.241195741195741
"42101007000",2654,5300,2646,0.499245283018868,0.500754716981132
"42101007100",4358,9892,5534,0.559441973311767,0.440558026688233
"42101007200",2972,6080,3108,0.511184210526316,0.488815789473684
"42101007300",2245,3808,1563,0.410451680672269,0.589548319327731
"42101007400",2130,5321,3191,0.599699304641985,0.400300695358015
"42101007500",0,0,0,NA,NA
"42101007600",0,294,294,1,0
"42101007700",854,1731,877,0.506643558636626,0.493356441363374
"42101007800",3003,4648,1645,0.353915662650602,0.646084337349398
"42101007900",3122,4729,1607,0.339818143370691,0.660181856629309
"42101008000",2646,4783,2137,0.446790717123144,0.553209282876856
"42101008100",4901,9297,4396,0.472840701301495,0.527159298698505
"42101008200",4680,7996,3316,0.414707353676838,0.585292646323162
"42101008300",5737,9937,4200,0.422662775485559,0.577337224514441
"42101008400",2952,5205,2253,0.432853025936599,0.567146974063401
"42101008500",3866,7673,3807,0.49615534992832,0.50384465007168
"42101008600",2894,6496,3602,0.554495073891626,0.445504926108374
"42101008700",3210,7230,4020,0.556016597510373,0.443983402489627
"42101008800",1315,4734,3419,0.722222222222222,0.277777777777778
"42101008900",356,1030,674,0.654368932038835,0.345631067961165
"42101009000",1397,3299,1902,0.576538344953016,0.423461655046984
"42101009100",1231,3025,1794,0.593057851239669,0.406942148760331
"42101009200",676,2869,2193,0.764377831997212,0.235622168002788
"42101009300",2236,4799,2563,0.534069597832882,0.465930402167118
"42101009400",1766,4305,2539,0.589779326364692,0.410220673635308
"42101009500",1832,3839,2007,0.522792393852566,0.477207606147434
"42101009600",2493,4915,2422,0.492777212614446,0.507222787385554
"42101009700",56,63,7,0.111111111111111,0.888888888888889
"42101009800",5179,7263,2084,0.286933773922621,0.713066226077379
"42101009900",358,367,9,0.0245231607629428,0.975476839237057
"42101010000",2621,3818,1197,0.313514929282347,0.686485070717653
"42101010100",3892,6299,2407,0.382124146689951,0.617875853310049
"42101010200",1400,3278,1878,0.572910311165345,0.427089688834655
"42101010300",1507,2850,1343,0.471228070175439,0.528771929824561
"42101010400",1725,4061,2336,0.575227776409751,0.424772223590249
"42101010500",1192,4527,3335,0.736690965319196,0.263309034680804
"42101010600",612,1605,993,0.618691588785047,0.381308411214953
"42101010700",1153,4116,2963,0.719873663751215,0.280126336248785
"42101010800",1538,4727,3189,0.674635075100487,0.325364924899513
"42101010900",805,2417,1612,0.666942490690939,0.333057509309061
"42101011000",2012,4636,2624,0.566005176876618,0.433994823123382
"42101011100",1913,5277,3364,0.637483418609058,0.362516581390942
"42101011200",3077,6532,3455,0.52893447642376,0.47106552357624
"42101011300",2096,3515,1419,0.403698435277383,0.596301564722617
"42101011400",4828,7232,2404,0.332411504424779,0.667588495575221
"42101011500",2719,3770,1051,0.278779840848806,0.721220159151194
"42101011600",2370,3010,640,0.212624584717608,0.787375415282392
"42101011700",1094,1531,437,0.285434356629654,0.714565643370346
"42101011800",5217,6954,1737,0.249784296807593,0.750215703192407
"42101011900",4147,6249,2102,0.33637381981117,0.66362618018883
"42101012000",1702,1899,197,0.103738809899947,0.896261190100053
"42101012100",1764,2623,859,0.32748760960732,0.67251239039268
"42101012200",4536,6621,2085,0.314907113729044,0.685092886270956
"42101012300",13,85,72,0.847058823529412,0.152941176470588
"42101012400",0,0,0,NA,NA
"42101012500",2272,3328,1056,0.317307692307692,0.682692307692308
"42101012600",358,682,324,0.475073313782991,0.524926686217009
"42101012700",99,392,293,0.747448979591837,0.252551020408163
"42101012800",157,172,15,0.0872093023255814,0.912790697674419
"42101012900",369,453,84,0.185430463576159,0.814569536423841
"42101013000",603,1118,515,0.460644007155635,0.539355992844365
"42101013100",649,2068,1419,0.686170212765957,0.313829787234043
"42101013200",645,4012,3367,0.839232303090728,0.160767696909272
"42101013300",752,2169,1417,0.653296449976948,0.346703550023052
"42101013400",3793,5355,1562,0.291690009337068,0.708309990662932
"42101013500",1846,3554,1708,0.480585256049522,0.519414743950478
"42101013600",4612,5872,1260,0.214577656675749,0.785422343324251
"42101013700",2364,6518,4154,0.637312058913777,0.362687941086223
"42101013800",753,2925,2172,0.742564102564103,0.257435897435897
"42101013900",987,3835,2848,0.742633637548892,0.257366362451108
"42101014000",1008,3548,2540,0.715896279594138,0.284103720405862
"42101014100",453,2763,2310,0.836047774158523,0.163952225841477
"42101014200",1313,2247,934,0.415665331553182,0.584334668446818
"42101014300",867,1404,537,0.382478632478632,0.617521367521368
"42101014400",1073,3167,2094,0.661193558572782,0.338806441427218
"42101014500",412,2104,1692,0.804182509505703,0.195817490494297
"42101014600",1391,2652,1261,0.475490196078431,0.524509803921569
"42101014700",577,2201,1624,0.737846433439346,0.262153566560654
"42101014800",264,1286,1022,0.794712286158631,0.205287713841369
"42101014900",1776,5821,4045,0.69489778388593,0.30510221611407
"42101015000",49,97,48,0.494845360824742,0.505154639175258
"42101015100",2490,9156,6666,0.728047182175623,0.271952817824377
"42101015200",1466,7925,6459,0.815015772870663,0.184984227129337
"42101015300",1065,3480,2415,0.693965517241379,0.306034482758621
"42101015400",464,865,401,0.463583815028902,0.536416184971098
"42101015500",464,3403,2939,0.863649720834558,0.136350279165442
"42101015600",453,2204,1751,0.794464609800363,0.205535390199637
"42101015700",993,2918,1925,0.659698423577793,0.340301576422207
"42101015800",3677,5975,2298,0.384602510460251,0.615397489539749
"42101015900",1013,1755,742,0.422792022792023,0.577207977207977
"42101016000",4926,7934,3008,0.379127804386186,0.620872195613814
"42101016100",1724,6071,4347,0.716027013671553,0.283972986328447
"42101016200",655,2739,2084,0.760861628331508,0.239138371668492
"42101016300",604,4084,3480,0.852105778648384,0.147894221351616
"42101016400",793,5557,4764,0.857297102753284,0.142702897246716
"42101016500",1273,3969,2696,0.679264298311917,0.320735701688083
"42101016600",532,1366,834,0.610541727672035,0.389458272327965
"42101016700",2917,8430,5513,0.653973902728351,0.346026097271649
"42101016800",1801,5354,3553,0.66361598804632,0.33638401195368
"42101016900",4706,12235,7529,0.615365753984471,0.384634246015529
"42101017000",1450,3906,2456,0.628776241679467,0.371223758320533
"42101017100",2400,5211,2811,0.539435808865861,0.460564191134139
"42101017200",4483,9885,5402,0.546484572584724,0.453515427415276
"42101017300",1711,3768,2057,0.545912951167728,0.454087048832272
"42101017400",1193,3371,2178,0.646099080391575,0.353900919608425
"42101017500",2164,8966,6802,0.758643765335713,0.241356234664287
"42101017600",1472,11395,9923,0.87082053532251,0.12917946467749
"42101017700",3429,8580,5151,0.60034965034965,0.39965034965035
"42101017800",2598,6207,3609,0.581440309328178,0.418559690671822
"42101017900",3030,6424,3394,0.528331257783313,0.471668742216687
"42101018000",5562,8367,2805,0.335245607744711,0.664754392255289
"42101018100",123,189,66,0.349206349206349,0.650793650793651
"42101018200",205,357,152,0.425770308123249,0.574229691876751
"42101018300",3182,4208,1026,0.243821292775665,0.756178707224335
"42101018400",1625,2338,713,0.304961505560308,0.695038494439692
"42101018500",94,132,38,0.287878787878788,0.712121212121212
"42101018600",3383,4820,1437,0.298132780082988,0.701867219917012
"42101018700",994,1698,704,0.414605418138987,0.585394581861013
"42101018800",4528,7100,2572,0.362253521126761,0.637746478873239
"42101018900",720,1027,307,0.298928919182084,0.701071080817916
"42101019000",4486,6378,1892,0.296644716211979,0.703355283788021
"42101019100",4413,6019,1606,0.266821731184582,0.733178268815418
"42101019200",3594,7078,3484,0.492229443345578,0.507770556654422
"42101019300",88,119,31,0.260504201680672,0.739495798319328
"42101019400",265,404,139,0.344059405940594,0.655940594059406
"42101019500",2591,8609,6018,0.699035892670461,0.300964107329539
"42101019600",760,2504,1744,0.696485623003195,0.303514376996805
"42101019700",2647,7799,5152,0.660597512501603,0.339402487498397
"42101019800",2606,6923,4317,0.62357359526217,0.37642640473783
"42101019900",1164,5352,4188,0.782511210762332,0.217488789237668
"42101020000",762,1792,1030,0.574776785714286,0.425223214285714
"42101020100",2965,7958,4993,0.627418949484795,0.372581050515205
"42101020200",2795,6102,3307,0.541953457882661,0.458046542117339
"42101020300",1779,3739,1960,0.524204332709281,0.475795667290719
"42101020400",1620,3786,2166,0.572107765451664,0.427892234548336
"42101020500",1677,3465,1788,0.516017316017316,0.483982683982684
"42101020600",1290,1584,294,0.185606060606061,0.814393939393939
"42101020700",3992,6202,2210,0.356336665591745,0.643663334408255
"42101020800",1025,1245,220,0.176706827309237,0.823293172690763
"42101020900",2200,3013,813,0.269830733488218,0.730169266511782
"42101021000",4230,5470,1240,0.226691042047532,0.773308957952468
"42101021100",2193,2572,379,0.147356143079316,0.852643856920684
"42101021200",2067,2446,379,0.154946852003271,0.845053147996729
"42101021300",2907,3816,909,0.238207547169811,0.761792452830189
"42101021400",2588,3840,1252,0.326041666666667,0.673958333333333
"42101021500",2790,3567,777,0.217830109335576,0.782169890664424
"42101021600",1072,1418,346,0.244005641748942,0.755994358251058
"42101021700",5761,6369,608,0.0954623959805307,0.904537604019469
"42101021800",3350,4044,694,0.171612265084075,0.828387734915925
"42101021900",1161,1339,178,0.13293502613891,0.86706497386109
"42101022000",1290,1417,127,0.0896259703599153,0.910374029640085
"42101022100",1095,1177,82,0.0696686491079015,0.930331350892099
"42101022200",1480,1595,115,0.0721003134796238,0.927899686520376
"42101022300",291,427,136,0.318501170960187,0.681498829039813
"42101022400",262,312,50,0.16025641025641,0.83974358974359
"42101022500",268,278,10,0.0359712230215827,0.964028776978417
"42101022600",276,405,129,0.318518518518519,0.681481481481481
"42101022700",1300,1446,146,0.100968188105118,0.899031811894882
"42101022800",1352,1471,119,0.0808973487423521,0.919102651257648
"42101022900",302,314,12,0.0382165605095541,0.961783439490446
"42101023000",427,439,12,0.0273348519362187,0.972665148063781
"42101023100",1217,1290,73,0.0565891472868217,0.943410852713178
"42101023200",555,699,144,0.206008583690987,0.793991416309013
"42101023300",2734,3234,500,0.15460729746444,0.84539270253556
"42101023400",501,591,90,0.152284263959391,0.847715736040609
"42101023500",1115,1233,118,0.0957015409570154,0.904298459042985
"42101023600",2247,2505,258,0.102994011976048,0.897005988023952
"42101023700",3562,4948,1386,0.280113177041229,0.719886822958771
"42101023800",3138,4352,1214,0.278952205882353,0.721047794117647
"42101023900",1013,1689,676,0.400236826524571,0.599763173475429
"42101024000",2443,4181,1738,0.415690026309495,0.584309973690505
"42101024100",498,1335,837,0.626966292134831,0.373033707865169
"42101024200",2485,4245,1760,0.414605418138987,0.585394581861013
"42101024300",2836,4378,1542,0.352215623572407,0.647784376427593
"42101024400",1762,3467,1705,0.491779636573406,0.508220363426594
"42101024500",2076,4503,2427,0.538974017321786,0.461025982678214
"42101024600",1272,3309,2037,0.615593834995467,0.384406165004533
"42101024700",2768,5536,2768,0.5,0.5
"42101024800",1382,2273,891,0.391992960844699,0.608007039155301
"42101024900",2350,4105,1755,0.427527405602923,0.572472594397077
"42101025000",432,842,410,0.486935866983373,0.513064133016627
"42101025100",1812,2252,440,0.19538188277087,0.80461811722913
"42101025200",4334,7278,2944,0.404506732618851,0.595493267381149
"42101025300",2640,4252,1612,0.379115710253998,0.620884289746002
"42101025400",3584,4675,1091,0.233368983957219,0.766631016042781
"42101025500",2249,2751,502,0.182479098509633,0.817520901490367
"42101025600",2505,2834,329,0.116090331686662,0.883909668313338
"42101025700",2738,3507,769,0.219275734245794,0.780724265754206
"42101025800",1418,1779,361,0.20292299044407,0.79707700955593
"42101025900",4326,5511,1185,0.215024496461622,0.784975503538378
"42101026000",2903,3502,599,0.171045117075957,0.828954882924043
"42101026100",2984,3605,621,0.172260748959778,0.827739251040222
"42101026200",4312,5164,852,0.164988381099923,0.835011618900077
"42101026300",8352,10932,2580,0.236004390779363,0.763995609220637
"42101026400",5247,6443,1196,0.185627813130529,0.814372186869471
"42101026500",3518,5350,1832,0.342429906542056,0.657570093457944
"42101026600",5270,7476,2206,0.295077581594436,0.704922418405564
"42101026700",5362,7787,2425,0.31141646333633,0.68858353666367
"42101026800",3073,4345,1272,0.292750287686997,0.707249712313003
"42101026900",1414,2029,615,0.303104977821587,0.696895022178413
"42101027000",1851,2184,333,0.152472527472527,0.847527472527473
"42101027100",1522,2309,787,0.340840190558683,0.659159809441317
"42101027200",3650,4592,942,0.2051393728223,0.7948606271777
"42101027300",3907,5514,1607,0.291439970982952,0.708560029017048
"42101027400",6056,9612,3556,0.369954223886808,0.630045776113192
"42101027500",3277,4651,1374,0.29542033971189,0.70457966028811
"42101027600",2262,4250,1988,0.467764705882353,0.532235294117647
"42101027700",3036,5279,2243,0.424891077855654,0.575108922144346
"42101027800",3186,5248,2062,0.392911585365854,0.607088414634146
"42101027900",3308,7059,3751,0.531378382207112,0.468621617792888
"42101028000",2787,5165,2378,0.460406582768635,0.539593417231365
"42101028100",2310,4309,1999,0.463912740775122,0.536087259224878
"42101028200",2830,5376,2546,0.47358630952381,0.52641369047619
"42101028300",4265,8727,4462,0.511286811046179,0.488713188953821
"42101028400",2649,5817,3168,0.544610624033007,0.455389375966993
"42101028500",1340,2266,926,0.40864960282436,0.59135039717564
"42101028600",3407,7082,3675,0.518921208698108,0.481078791301892
"42101028700",1388,2542,1154,0.453973249409913,0.546026750590087
"42101028800",1536,3749,2213,0.590290744198453,0.409709255801547
"42101028900",4862,8423,3561,0.422770984209901,0.577229015790099
"42101029000",3741,5646,1905,0.33740701381509,0.66259298618491
"42101029100",2519,4448,1929,0.433678057553957,0.566321942446043
"42101029200",2688,3929,1241,0.315856452023416,0.684143547976584
"42101029300",1465,2878,1413,0.4909659485754,0.5090340514246
"42101029400",1508,3316,1808,0.545235223160434,0.454764776839566
"42101029500",687,1076,389,0.361524163568773,0.638475836431227
"42101029600",643,1100,457,0.415454545454545,0.584545454545454
"42101029700",244,399,155,0.388471177944862,0.611528822055138
"42101029800",2990,4179,1189,0.284517827231395,0.715482172768605
"42101029900",2370,4321,1951,0.451515852811849,0.548484147188151
"42101030000",3485,6828,3343,0.489601640304628,0.510398359695372
"42101030100",3699,5405,1706,0.315633672525439,0.684366327474561
"42101030200",4947,6463,1516,0.234565991025839,0.765434008974161
"42101030300",5290,6901,1611,0.233444428343718,0.766555571656282
"42101030400",451,619,168,0.27140549273021,0.72859450726979
"42101030500",7489,9547,2058,0.215565098983974,0.784434901016026
"42101030600",5022,6274,1252,0.199553713739241,0.800446286260759
"42101030700",2194,2819,625,0.221709826179496,0.778290173820504
"42101030800",3836,4403,567,0.128775834658188,0.871224165341812
"42101030900",2601,3278,677,0.206528370957901,0.793471629042099
"42101031000",4668,5611,943,0.168062733915523,0.831937266084477
"42101031100",6112,7864,1752,0.222787385554425,0.777212614445575
"42101031200",2910,3846,936,0.243369734789392,0.756630265210608
"42101031300",3863,5362,1499,0.279559865721746,0.720440134278254
"42101031400",7065,9568,2503,0.261601170568562,0.738398829431438
"42101031500",7415,9379,1964,0.209403987631944,0.790596012368056
"42101031600",4524,5530,1006,0.181916817359855,0.818083182640145
"42101031700",4369,5581,1212,0.21716538254793,0.78283461745207
"42101031800",2711,3456,745,0.21556712962963,0.78443287037037
"42101031900",3593,4810,1217,0.253014553014553,0.746985446985447
"42101032000",4996,6449,1453,0.225306249030857,0.774693750969143
"42101032100",2821,3888,1067,0.274434156378601,0.725565843621399
"42101032200",53,190,137,0.721052631578947,0.278947368421053
"42101032300",2519,3577,1058,0.295778585406765,0.704221414593235
"42101032400",14,14,0,0,1
"42101032500",4084,5730,1646,0.287260034904014,0.712739965095986
"42101032600",5083,6733,1650,0.245061636714689,0.754938363285311
"42101032700",77,203,126,0.620689655172414,0.379310344827586
"42101032800",0,0,0,NA,NA
"42101032900",3061,4086,1025,0.250856583455702,0.749143416544298
"42101033000",5718,7402,1684,0.22750607943799,0.77249392056201
"42101033100",7345,9099,1754,0.192768436091878,0.807231563908122
"42101033200",2176,2594,418,0.161141094834233,0.838858905165767
"42101033300",2764,3393,629,0.185381668140289,0.814618331859711
"42101033400",3180,4098,918,0.224011713030747,0.775988286969253
"42101033500",2801,3400,599,0.176176470588235,0.823823529411765
"42101033600",4819,6133,1314,0.214250774498614,0.785749225501386
"42101033700",6794,9006,2212,0.245614035087719,0.754385964912281
"42101033800",4190,5461,1271,0.232741256180187,0.767258743819813
"42101033900",2498,2909,411,0.141285665177037,0.858714334822963
"42101034000",2228,2421,193,0.0797191243287898,0.92028087567121
"42101034100",4529,5556,1027,0.184845212383009,0.815154787616991
"42101034200",2641,3252,611,0.187884378843788,0.812115621156211
"42101034300",166,166,0,0,1
"42101034400",6788,7534,746,0.0990177860366339,0.900982213963366
"42101034500",5760,7887,2127,0.269684290604793,0.730315709395207
"42101034600",878,1440,562,0.390277777777778,0.609722222222222
"42101034700",8934,10242,1308,0.127709431751611,0.872290568248389
"42101034800",12289,14866,2577,0.173348580653841,0.826651419346159
"42101034900",4628,7002,2374,0.339045986860897,0.660954013139103
"42101035100",3016,3698,682,0.184424012979989,0.815575987020011
"42101035200",3734,4561,827,0.181319885989914,0.818680114010085
"42101035300",9431,10674,1243,0.116451189807008,0.883548810192992
"42101035400",0,0,0,NA,NA
"42101035500",5430,6950,1520,0.218705035971223,0.781294964028777
"42101035600",6706,8147,1441,0.176874923284645,0.823125076715355
"42101035700",5715,8670,2955,0.34083044982699,0.65916955017301
"42101035800",5196,6113,917,0.150008179290038,0.849991820709962
"42101035900",4302,5454,1152,0.211221122112211,0.788778877887789
"42101036000",2326,2678,352,0.131441374159821,0.868558625840179
"42101036100",3639,4046,407,0.10059317844785,0.89940682155215
"42101036200",15466,17935,2469,0.137663785893504,0.862336214106496
"42101036300",13677,15696,2019,0.128631498470948,0.871368501529052
"42101036400",12,70,58,0.828571428571429,0.171428571428571
"42101036500",7516,9075,1559,0.171790633608815,0.828209366391185
"42101036600",360,403,43,0.106699751861042,0.893300248138958
"42101036700",0,0,0,NA,NA
